8479411,9,5,1,0,1
8478569,13,121,25,18,43
8478569,6,180,18,13,31
8480884,30,18,2,2,4
8475844,10,1,0,0,0
8475844,8,36,2,9,11
8475844,1,27,4,9,13
8475844,6,5,0,1,1
8475844,19,7,1,2,3
8475844,20,10,1,1,2
8475461,24,8,1,1,2
8475461,9,1,0,0,0
8475461,5,17,0,2,2
8475461,21,21,1,4,5
8482072,6,8,1,0,1
8478427,12,436,178,214,392
8480222,2,54,3,13,16
8479329,18,1,0,0,0
8479322,4,15,4,3,7
8481629,9,4,0,0,0
8475729,26,2,0,0,0
8475729,21,9,0,0,0
8475729,4,9,0,0,0
8478020,26,168,16,23,39
8478020,9,5,0,1,1
8478020,54,44,8,6,14
8478020,10,3,0,0,0
8479315,10,5,0,0,0
8479315,1,52,8,5,13
8476981,8,112,35,17,52
8476981,29,267,65,50,115
8479998,26,115,4,15,19
8479994,26,50,7,5,12
8480072,26,42,3,4,7
8480072,3,66,3,6,9
8478397,20,288,16,90,106
8476404,4,20,0,1,1
8476404,2,6,1,0,1
8476404,26,159,13,11,24
8478074,5,31,3,2,5
8473573,9,68,17,12,29
8473573,16,291,77,78,155
8473573,29,168,40,44,84
8478891,52,149,21,23,44
8478891,55,49,6,11,17
8476326,22,121,19,16,35
8476326,53,107,17,16,33
8476326,5,14,3,0,3
8476469,8,213,42,39,81
8476469,52,179,26,32,58
8476469,7,1,0,0,0
8478042,18,385,127,112,239
8478042,26,59,20,22,42
8479335,7,129,14,24,38
8479944,5,213,29,33,62
8479944,24,9,2,1,3
8476960,26,69,19,18,37
8476960,17,294,83,71,154
8476960,22,9,1,1,2
8474715,29,600,206,182,388
8474715,4,72,23,27,50
8477979,4,102,10,18,28
8477979,21,58,9,8,17
8470655,24,21,3,4,7
8470655,6,217,39,55,94
8470655,19,281,80,108,188
8474150,20,678,151,234,385
8473563,15,684,163,478,641
8480860,1,14,0,3,3
8474573,2,691,123,302,425
8477473,23,19,0,0,0
8477473,4,11,0,1,1
8477473,7,52,5,3,8
8478870,28,91,16,19,35
8478870,9,51,6,11,17
8482222,10,13,0,1,1
8482222,28,72,13,31,44
8477964,19,341,65,77,142
8477493,13,588,215,329,544
8479718,14,29,6,2,8
8479718,55,2,0,1,1
8475197,22,120,14,69,83
8475197,10,70,5,34,39
8475197,21,474,75,232,307
8480289,3,18,1,1,2
8480289,52,6,1,1,2
8474749,30,3,1,0,1
8474749,20,42,1,4,5
8474749,23,80,6,12,18
8474749,6,122,0,24,24
8478445,2,351,90,210,300
8479414,1,98,16,8,24
8479414,55,12,1,1,2
8480208,9,135,37,54,91
8479945,29,48,1,8,9
8479945,25,19,2,3,5
8474291,23,142,6,20,26
8474291,53,29,1,0,1
8474291,15,389,44,62,106
8479402,12,44,1,11,12
8479402,29,58,5,15,20
8478451,22,132,8,25,33
8478451,12,53,4,9,13
8480814,16,22,2,4,6
8476470,52,105,1,17,18
8476470,7,89,4,12,16
8476470,8,225,7,53,60
8478463,2,401,92,95,187
8477930,21,122,18,15,33
8477930,14,71,8,10,18
8477930,54,148,12,19,31
8477930,4,237,17,17,34
8479356,2,57,9,10,19
8478011,30,4,0,2,2
8475968,8,13,0,1,1
8480205,29,108,18,16,34
8473994,25,716,259,349,608
8474818,23,75,2,14,16
8474818,52,8,0,1,1
8474818,30,31,1,4,5
8474818,8,171,11,28,39
8474818,25,299,11,58,69
8477935,20,402,67,73,140
8477935,13,72,33,27,60
8476988,18,110,1,14,15
8476988,22,248,15,46,61
8481122,24,54,1,3,4
8470638,6,670,251,320,571
8481640,28,13,0,1,1
8480879,9,13,0,1,1
8477479,17,267,80,100,180
8473415,17,62,0,6,6
8473415,10,2,0,0,0
8473415,23,179,4,32,36
8478056,9,22,0,4,4
8478056,12,25,1,3,4
8475868,3,14,1,3,4
8475868,52,51,0,8,8
8475868,30,18,0,0,0
8475868,18,114,2,17,19
8478075,6,138,16,23,39
8478075,7,67,7,5,12
8477416,29,373,107,120,227
8481600,26,105,1,13,14
8475760,30,90,12,17,29
8475760,5,45,10,6,16
8475760,13,394,87,104,191
8476278,3,47,12,10,22
8476278,55,39,8,9,17
8476278,10,9,2,0,2
8476278,18,33,3,7,10
8478104,19,119,17,18,35
8478104,3,14,0,4,4
8479571,28,8,1,0,1
8477320,6,69,4,8,12
8476927,5,197,31,45,76
8478444,23,317,117,131,248
8474567,10,45,0,4,4
8474567,14,48,3,7,10
8474567,7,243,13,54,67
8474567,52,129,11,27,38
8474009,30,55,10,16,26
8474009,28,69,11,9,20
8474009,18,219,47,48,95
8474009,5,143,27,39,66
8474009,23,75,15,24,39
8474009,24,104,27,35,62
8480871,16,76,6,23,29
8480871,29,48,11,10,21
8480003,1,109,14,14,28
8478840,7,14,0,0,0
8478840,55,26,1,4,5
8480158,14,7,0,2,2
8480158,10,48,3,8,11
8474697,18,70,0,4,4
8474697,9,373,15,36,51
8474145,19,368,14,35,49
8474145,5,107,4,16,20
8480803,22,93,13,31,44
8477474,16,2,0,1,1
8477474,23,2,0,0,0
8477474,17,70,4,17,21
8477474,15,84,1,17,18
8476329,10,20,3,5,8
8476329,23,19,2,0,2
8476329,53,64,13,17,30
8476329,15,85,8,23,31
8475098,19,217,34,61,95
8475098,10,402,95,164,259
8480073,9,106,2,26,28
8473544,53,53,8,12,20
8473544,4,31,6,10,16
8473544,22,9,2,0,2
8473544,2,66,10,22,32
8473544,5,54,12,11,23
8473544,21,20,4,0,4
8473544,13,10,1,3,4
8473544,9,139,32,45,77
8473544,3,254,69,105,174
8473544,29,34,7,11,18
8479407,1,298,67,130,197
8474027,4,176,9,32,41
8474027,3,4,1,1,2
8474027,28,513,20,112,132
8478465,23,10,0,0,0
8474673,10,128,5,33,38
8474673,20,577,46,206,252
8476463,30,670,43,153,196
8477380,3,25,2,1,3
8477380,28,3,0,1,1
8477380,26,54,6,5,11
8482240,17,26,1,1,2
8478996,10,18,4,4,8
8478996,52,13,0,0,0
8478996,54,7,2,0,2
8478996,8,4,0,1,1
8477015,9,185,47,68,115
8477015,10,253,43,56,99
8470606,26,694,161,189,350
8477384,9,72,0,7,7
8477384,6,3,0,0,0
8477384,13,93,4,6,10
8479366,9,30,1,8,9
8479366,19,29,3,4,7
8477887,54,5,1,0,1
8477887,4,43,4,5,9
8477887,12,28,1,1,2
8480196,7,103,2,16,18
8477402,3,301,79,116,195
8477402,19,63,25,35,60
8479382,4,54,1,2,3
8478047,53,26,11,3,14
8478047,10,72,20,37,57
8477444,21,181,59,83,142
8477444,15,328,62,83,145
8470613,28,706,160,390,550
8477335,21,5,0,1,1
8477335,23,39,1,4,5
8477355,1,238,14,92,106
8477355,7,36,2,6,8
8482124,26,40,5,4,9
8481524,21,40,5,9,14
8474038,8,380,81,79,160
8474038,20,108,13,28,41
8479381,25,36,1,2,3
8479465,53,27,1,6,7
8479465,7,29,4,4,8
8479465,16,66,14,13,27
8479465,22,156,27,22,49
8474685,21,150,23,31,54
8474685,29,361,61,65,126
8478476,53,50,3,3,6
8478443,6,394,21,49,70
8474590,15,691,112,398,510
8478506,29,71,3,11,14
8479523,16,18,0,2,2
8479523,13,36,3,6,9
8477846,16,168,10,21,31
8477846,20,6,0,1,1
8477846,54,104,14,18,32
8477846,28,28,2,3,5
8477901,15,6,0,1,1
8477901,18,11,1,0,1
8477901,54,6,1,0,1
8477901,8,94,14,20,34
8476941,1,60,3,12,15
8476941,25,14,1,3,4
8476941,10,130,8,16,24
8476941,15,37,1,5,6
8475842,24,89,14,14,28
8475842,10,19,1,1,2
8478851,18,91,3,28,31
8477478,54,273,29,35,64
8477478,7,41,5,3,8
8470604,26,564,188,186,374
8470604,5,82,26,24,50
8482654,4,15,1,1,2
8481540,8,68,22,21,43
8476879,5,53,4,13,17
8476879,22,69,4,21,25
8476879,10,56,1,7,8
8476879,9,440,32,86,118
8478416,14,216,16,38,54
8478469,9,309,41,143,184
8475808,53,15,0,0,0
8475808,8,32,0,5,5
8475808,23,77,4,5,9
8475808,29,58,2,6,8
8465009,15,55,2,8,10
8465009,2,62,0,10,10
8465009,6,546,68,129,197
8478970,23,18,0,1,1
8478970,12,16,0,3,3
8480276,28,4,0,1,1
8475279,8,164,17,29,46
8475279,13,10,1,4,5
8475279,52,305,12,52,64
8475163,22,183,42,36,78
8475163,23,60,10,8,18
8475163,15,61,9,9,18
8475163,20,81,12,12,24
8475163,9,153,19,21,40
8475163,25,86,19,23,42
8478488,9,57,5,6,11
8480053,28,14,0,5,5
8479395,17,104,10,17,27
8479395,15,7,0,1,1
8479345,53,337,53,89,142
8480078,3,246,41,49,90
8478519,14,285,64,91,155
8475231,2,638,90,105,195
8476368,28,4,0,0,0
8476368,14,11,0,0,0
8476368,1,5,1,1,2
8476368,3,37,2,4,6
8476368,9,113,4,16,20
8479348,26,33,0,11,11
8479348,8,24,2,3,5
8475160,19,52,4,4,8
8475160,10,33,1,4,5
8475160,26,503,48,55,103
8477365,6,144,5,13,18
8473504,2,587,68,84,152
8473504,30,42,4,6,10
8470601,9,16,0,2,2
8470601,2,3,0,0,0
8470601,14,350,12,54,66
8470601,4,154,7,24,31
8479639,54,86,6,13,19
8471699,25,154,11,20,31
8471699,28,56,4,11,15
8471699,21,9,0,1,1
8471699,24,502,89,118,207
8474013,30,52,1,7,8
8474013,21,138,6,35,41
8474013,12,68,2,16,18
8474013,5,218,9,50,59
8474013,29,20,2,5,7
8474013,19,115,7,14,21
8476399,14,64,14,18,32
8476399,20,71,14,16,30
8476399,1,237,57,37,94
8479525,14,99,25,19,44
8471260,25,189,20,29,49
8471260,21,237,33,57,90
8471260,5,61,16,15,31
8471260,29,70,7,14,21
8471260,20,33,4,3,7
8477456,21,331,67,67,134
8480031,24,140,26,37,63
8475246,13,20,0,1,1
8475246,4,21,1,2,3
8475246,21,4,0,0,0
8475246,53,185,16,23,39
8475246,29,81,10,17,27
8475246,25,44,1,9,10
8475792,13,90,21,16,37
8475792,16,19,1,2,3
8475792,15,217,52,44,96
8475792,6,76,9,18,27
8475792,14,66,14,3,17
8478398,52,376,173,163,336
8477429,52,467,74,110,184
8477429,3,10,4,7,11
8476393,18,111,13,25,38
8476393,8,58,9,13,22
8476393,54,7,1,2,3
8476393,53,152,19,27,46
8476393,4,107,12,15,27
8474053,28,650,228,268,496
8476461,4,644,167,266,433
8475745,6,214,40,60,100
8475745,30,479,91,151,242
8481528,7,112,17,32,49
8476390,30,4,0,1,1
8476390,24,49,4,6,10
8476390,23,10,0,0,0
8471675,5,666,291,500,791
8478474,53,346,56,54,110
8477680,5,1,0,0,0
8477680,22,21,2,3,5
8478512,2,15,2,3,5
8478512,55,6,0,2,2
8478512,20,62,8,13,21
8478512,6,59,5,12,17
8477814,5,2,0,0,0
8477814,2,13,0,2,2
8481523,16,150,19,40,59
8474149,9,55,13,7,20
8474149,54,69,18,18,36
8474149,13,225,81,101,182
8480839,7,269,27,124,151
8477936,2,112,8,13,21
8474610,29,25,2,2,4
8474610,13,1,0,0,0
8474610,30,11,2,2,4
8474610,7,21,1,2,3
8474610,23,55,4,3,7
8474610,12,10,1,2,3
8476479,8,360,54,140,194
8476479,26,72,21,23,44
8476479,16,32,1,4,5
8475869,7,6,0,0,0
8475869,20,7,0,0,0
8475869,28,5,0,0,0
8475869,16,10,0,1,1
8475869,22,114,8,9,17
8475869,2,15,1,1,2
8475869,8,23,0,3,3
8479602,18,21,0,2,2
8475177,16,139,5,18,23
8475177,12,74,1,13,14
8475177,2,303,12,69,81
8477455,19,47,1,5,6
8477455,17,76,4,9,13
8477455,8,119,8,11,19
8478029,24,3,0,0,0
8478029,1,2,0,0,0
8478029,52,2,0,0,0
8477520,7,4,0,0,0
8477520,1,20,3,2,5
8477520,5,9,2,0,2
8477950,3,167,19,73,92
8477950,12,55,10,37,47
8477950,53,39,5,9,14
8479337,16,358,158,138,296
8478498,6,311,89,81,170
8477215,17,537,33,110,143
8474584,29,53,4,9,13
8474584,9,19,2,8,10
8474584,24,61,2,16,18
8474584,23,105,7,19,26
8474584,19,7,0,3,3
8474584,4,167,20,43,63
8474584,3,88,5,27,32
8474584,18,25,1,4,5
8480848,25,27,3,2,5
8476331,52,130,1,20,21
8476331,9,126,4,28,32
8476331,28,133,3,29,32
8474218,53,195,8,35,43
8474218,13,81,9,19,28
8474218,25,123,12,33,45
8474218,28,117,6,34,40
8480844,13,8,0,4,4
8478408,10,251,12,40,52
8478408,23,9,0,0,0
8475235,24,169,17,16,33
8475235,30,10,2,0,2
8475235,8,106,12,7,19
8475235,7,211,12,18,30
8476858,3,51,2,10,12
8476858,12,147,14,27,41
8476858,18,3,0,0,0
8477450,25,221,25,38,63
8477450,23,53,4,4,8
8475455,15,66,2,17,19
8475455,52,71,2,17,19
8475455,28,439,13,75,88
8475455,25,148,9,17,26
8477043,17,36,2,9,11
8477043,24,9,1,2,3
8477043,15,110,4,20,24
8480865,2,149,14,47,61
8477503,29,107,18,38,56
8477503,12,10,0,4,4
8477503,8,153,45,71,116
8477503,53,222,36,99,135
8477987,28,50,6,14,20
8477987,55,64,14,13,27
8477987,30,84,18,21,39
8477987,6,46,11,7,18
8475820,21,116,33,31,64
8475820,55,66,2,16,18
8475820,28,283,45,77,122
8474563,26,698,89,316,405
8475343,15,230,34,36,70
8475343,23,40,3,0,3
8475343,26,91,6,17,23
8475413,25,76,4,10,14
8475413,23,22,2,2,4
8477934,22,550,249,358,607
8480326,21,48,3,3,6
8480326,23,2,0,0,0
8477494,8,263,46,111,157
8477494,14,164,29,66,95
8482142,24,97,7,31,38
8479346,20,190,28,39,67
8479400,52,114,34,41,75
8479400,29,239,66,93,159
8475168,18,168,57,73,130
8475168,9,118,50,57,107
8475168,29,23,4,8,12
8475168,21,367,113,165,278
8477407,13,107,38,46,84
8477407,9,87,31,23,54
8477407,29,53,11,8,19
8477407,53,172,34,40,74
8477407,16,23,2,6,8
8477407,3,18,1,6,7
8476856,30,518,75,146,221
8475208,5,456,18,95,113
8478407,19,267,32,70,102
8478407,55,67,7,22,29
8482623,29,6,0,0,0
8477989,53,302,67,79,146
8477989,8,47,10,15,25
8476288,9,276,68,67,135
8476288,12,75,10,23,33
8476288,53,26,4,3,7
8476288,28,6,1,0,1
8476288,29,21,4,8,12
8475236,7,114,7,12,19
8475236,54,199,37,41,78
8475236,52,8,1,4,5
8475236,25,349,61,85,146
8474586,2,272,76,93,169
8474586,55,70,18,22,40
8474586,22,360,113,150,263
8471303,23,539,56,169,225
8471303,26,34,2,13,15
8476441,8,70,5,11,16
8476441,12,68,7,13,20
8476441,19,269,13,39,52
8477940,52,470,161,191,352
8478403,7,375,139,216,355
8478403,54,25,11,8,19
8477932,13,554,97,194,291
8475218,18,651,56,188,244
8475171,53,639,114,231,345
8475171,23,70,4,20,24
8474189,15,418,77,109,186
8474189,8,279,48,61,109
8475176,18,530,72,187,259
8475176,4,4,1,4,5
8478115,10,158,28,26,54
8474589,22,39,5,8,13
8474589,9,118,22,35,57
8474589,10,51,12,6,18
8474589,30,73,8,14,22
8474589,7,279,59,85,144
8480025,16,56,6,8,14
8470626,23,252,38,52,90
8470626,53,63,2,15,17
8470626,6,224,62,85,147
8470626,25,48,12,17,29
8478493,30,332,64,73,137
8477454,17,172,18,24,42
8477454,14,114,13,14,27
8478133,8,124,15,24,39
8477952,17,138,41,38,79
8477952,19,164,32,41,73
8479371,18,164,9,34,43
8476889,25,473,71,87,158
8480797,4,160,44,48,92
8480063,18,2,0,0,0
8477392,53,16,0,0,0
8477392,7,22,1,2,3
8475855,12,119,18,30,48
8475855,3,422,55,92,147
8475753,19,191,25,56,81
8475753,12,493,77,159,236
8479983,28,169,5,36,41
8477942,30,204,70,94,164
8477942,18,204,45,52,97
8470047,17,149,21,32,53
8470047,2,72,17,14,31
8470047,4,101,16,25,41
8470047,14,292,52,119,171
8478432,53,318,43,41,84
8477938,12,167,5,19,24
8477938,24,12,2,1,3
8477938,55,34,2,2,4
8477998,12,200,35,33,68
8477998,22,73,11,14,25
8476396,7,9,1,2,3
8476396,6,2,0,0,0
8476396,3,18,0,0,0
8475220,30,324,58,72,130
8475220,7,333,43,60,103
8473422,29,599,142,192,334
8473422,10,7,0,4,4
8473422,6,54,2,10,12
8479984,14,83,2,9,11
8481518,1,8,1,1,2
8475762,52,56,2,10,12
8475762,6,66,4,8,12
8475762,26,268,6,47,53
8475762,20,7,0,0,0
8480029,9,99,20,15,35
8476887,18,556,216,240,456
8478055,13,106,11,38,49
8478055,16,122,8,19,27
8480853,29,27,0,5,5
8475764,24,647,65,228,293
8479323,3,195,23,133,156
8479365,6,110,9,11,20
8478017,5,29,3,5,8
8478017,4,11,0,1,1
8476924,26,24,8,2,10
8476924,17,98,12,19,31
8476924,12,2,0,0,0
8475278,20,6,1,0,1
8475278,8,48,3,8,11
8475278,14,4,0,0,0
8475278,10,58,2,3,5
8473564,8,8,0,0,0
8473564,20,319,63,82,145
8473564,7,19,1,3,4
8473564,52,163,34,50,84
8473564,16,45,3,7,10
8480028,4,67,5,14,19
8476545,28,11,0,0,0
8476545,16,2,0,0,0
8476545,1,22,2,2,4
8476545,30,16,0,1,1
8479981,23,1,0,0,0
8479981,28,41,1,2,3
8474040,17,119,20,24,44
8474040,22,176,34,63,97
8474040,23,81,11,23,34
8474040,29,81,18,32,50
8474040,4,53,8,8,16
8474040,53,81,15,26,41
8476851,10,26,4,8,12
8476851,9,8,1,0,1
8476851,53,124,24,33,57
8476851,5,45,5,12,17
8476851,30,14,3,4,7
8476851,8,418,108,147,255
8475848,8,629,193,183,376
8479580,28,110,10,13,23
8479580,9,53,2,3,5
8474581,12,94,4,28,32
8474581,10,476,38,177,215
8479587,25,40,1,1,2
8478856,53,164,47,49,96
8478856,23,68,15,25,40
8478874,23,153,21,31,52
8478874,16,15,2,4,6
8478874,9,40,4,8,12
8477919,5,19,2,8,10
8477919,30,65,10,22,32
8477919,18,84,3,5,8
8476346,20,592,204,389,593
8477512,53,2,0,0,0
8477512,1,8,0,0,0
8477512,10,168,13,18,31
8479328,3,89,5,12,17
8479328,12,5,0,1,1
8478882,29,195,12,49,61
8478446,20,9,0,1,1
8479987,12,38,6,7,13
8479987,55,65,6,15,21
8471804,29,41,5,8,13
8471804,12,206,29,37,66
8471804,7,42,5,5,10
8479364,3,16,0,1,1
8470612,24,639,145,396,541
8478502,21,3,0,0,0
8478502,16,22,1,2,3
8470966,20,611,106,268,374
8470966,55,55,6,17,23
8470966,10,10,1,4,5
8479398,21,325,21,119,140
8479398,18,5,1,2,3
8473512,4,715,213,444,657
8473512,13,10,2,9,11
8479996,54,66,9,13,22
8479996,18,4,0,0,0
8476822,17,554,57,69,126
8476822,25,72,8,6,14
8471274,53,362,28,124,152
8471274,30,63,2,27,29
8471274,25,291,18,124,142
8476624,14,63,6,16,22
8476624,3,70,13,13,26
8476624,28,268,26,45,71
8476906,4,381,60,159,219
8476906,53,72,11,32,43
8476826,14,310,80,107,187
8476826,55,64,17,24,41
8475798,18,200,40,75,115
8475798,30,461,93,224,317
8474683,24,258,47,45,92
8474683,4,7,1,4,5
8474683,5,25,2,3,5
8474683,7,40,0,3,3
8474683,18,6,0,1,1
8474683,20,15,0,1,1
8474683,9,25,0,2,2
8476344,23,22,5,1,6
8476344,15,5,0,0,0
8476344,30,57,7,2,9
8477435,21,149,14,32,46
8477435,1,67,6,22,28
8472382,2,123,3,14,17
8472382,1,576,33,112,145
8478413,30,268,34,74,108
8478421,1,8,1,0,1
8478421,21,37,1,5,6
8479393,28,110,12,16,28
8476888,29,32,4,8,12
8476888,21,149,16,34,50
8476888,7,68,6,8,14
8476428,18,166,25,32,57
8476428,21,10,1,3,4
8476428,13,27,4,2,6
8480913,53,9,0,4,4
8480913,21,1,0,0,0
8479336,26,125,20,15,35
8476891,6,299,19,77,96
8475462,13,123,5,21,26
8475462,15,63,2,13,15
8475462,4,290,17,56,73
8475462,14,126,7,25,32
8475790,9,36,1,2,3
8475790,18,9,0,1,1
8475790,20,70,6,11,17
8475790,24,44,4,5,9
8475790,5,26,0,2,2
8475790,23,139,5,14,19
8475790,13,237,9,26,35
8477404,5,367,154,174,328
8474125,19,325,15,37,52
8474125,10,117,4,28,32
8478495,25,205,44,49,93
8477038,1,86,15,34,49
8477038,13,11,2,3,5
8481019,52,28,1,0,1
8476979,4,24,1,9,10
8476979,8,5,0,2,2
8476979,16,268,30,103,133
8476979,20,7,0,3,3
8481813,22,92,7,6,13
8479542,16,108,30,31,61
8479542,14,12,3,0,3
8474176,15,187,20,46,66
8474176,26,22,1,4,5
8474176,5,195,27,56,83
8474176,24,43,4,8,12
8474176,3,202,44,48,92
8477462,4,236,13,34,47
8477462,7,48,1,7,8
8477462,13,9,0,1,1
8479980,54,142,10,32,42
8479333,3,93,3,8,11
8475825,24,47,1,1,2
8475825,12,15,2,1,3
8475825,25,70,3,6,9
8474230,9,4,0,0,0
8474230,3,31,1,0,1
8474230,13,99,4,8,12
8474230,28,97,4,12,16
8475791,7,37,2,17,19
8475791,6,88,24,44,68
8475791,53,35,10,17,27
8475791,1,211,76,132,208
8475791,22,255,83,150,233
8476462,12,184,42,79,121
8476462,1,52,9,19,28
8476462,20,245,42,95,137
8476462,6,178,22,61,83
8474612,23,62,6,11,17
8474612,9,9,0,0,0
8474612,20,193,11,31,42
8474612,2,309,19,77,96
8482248,28,8,1,0,1
8478396,20,268,21,88,109
8478396,12,239,18,65,83
8477810,25,97,1,14,15
8477810,53,5,0,0,0
8477810,8,17,0,6,6
8482635,16,29,1,4,5
8478424,52,124,10,9,19
8477433,18,53,0,8,8
8477433,9,103,1,6,7
8476449,29,185,7,30,37
8476449,10,15,0,1,1
8476449,5,10,0,0,0
8477451,30,191,43,53,96
8477451,18,85,13,13,26
8477451,4,19,2,4,6
8477451,16,141,27,30,57
8477903,15,188,26,30,56
8477903,20,175,16,24,40
8475287,18,51,9,12,21
8475287,6,69,14,23,37
8475287,12,41,12,10,22
8475287,13,7,0,2,2
8475287,54,91,31,31,62
8475287,30,266,42,47,89
8477963,23,30,2,3,5
8477963,13,57,8,7,15
8477963,9,11,2,5,7
8477401,53,29,2,3,5
8477401,7,52,2,2,4
8477401,1,43,3,1,4
8477401,16,113,8,14,22
8475763,4,162,43,55,98
8475763,3,361,87,129,216
8475763,52,20,5,8,13
8480849,53,84,11,14,25
8475167,14,674,121,396,517
8478046,24,52,10,8,18
8478046,5,68,14,14,28
8478046,6,220,34,69,103
8481572,52,25,1,9,10
8480036,25,265,32,96,128
8471794,17,496,80,88,168
8471794,21,59,7,6,13
8474641,24,305,91,86,177
8474641,1,380,106,100,206
8480037,13,13,1,1,2
8476881,28,574,179,203,382
8474066,2,456,22,95,117
8478146,16,73,4,6,10
8478146,23,57,7,8,15
8476994,16,123,17,34,51
8476994,13,9,0,0,0
8476994,7,54,11,12,23
8476994,53,140,21,40,61
8478449,25,229,74,85,159
8481433,17,54,4,16,20
8480002,1,293,77,123,200
8471769,53,198,2,27,29
8471769,16,363,16,81,97
8474884,19,52,17,19,36
8474884,8,58,11,16,27
8474884,13,151,65,64,129
8474884,9,341,107,123,230
8481535,23,116,23,22,45
8474207,54,139,9,22,31
8474207,9,66,4,12,16
8474207,3,135,14,32,46
8474207,6,18,1,4,5
8474207,21,214,21,40,61
8474207,29,2,0,0,0
8475718,10,197,8,52,60
8471887,13,100,25,32,57
8471887,5,407,132,132,264
8471887,18,100,26,41,67
8477500,23,570,169,195,364
8479353,3,178,16,33,49
8479353,54,47,9,11,20
8479425,17,235,21,95,116
8476456,13,663,195,407,602
8478888,6,2,0,0,0
8481559,1,166,44,64,108
8480800,23,196,16,134,150
8476779,30,100,12,13,25
8476779,23,41,3,10,13
8476779,54,58,5,20,25
8476779,19,9,1,4,5
8476779,18,3,0,1,1
8476779,22,21,1,2,3
8478211,53,26,3,5,8
8478211,3,67,5,11,16
8478211,13,63,3,12,15
8477018,24,34,1,4,5
8477018,10,4,0,0,0
8477018,54,49,3,8,11
8477018,26,65,4,12,16
8477018,23,276,11,59,70
8475786,10,345,86,99,185
8475786,22,67,24,24,48
8480113,26,354,69,96,165
8475625,7,24,0,2,2
8475625,15,15,0,2,2
8475625,18,195,6,25,31
8475625,24,9,0,1,1
8475625,6,2,0,0,0
8475625,28,153,16,34,50
8476873,5,45,4,7,11
8476873,7,19,2,3,5
8476873,20,208,36,28,64
8477406,16,41,10,9,19
8477406,54,73,10,16,26
8477406,25,297,46,63,109
8475714,18,508,94,117,211
8475714,55,49,12,14,26
8475714,20,7,0,2,2
8478868,28,7,0,1,1
8478868,1,11,0,0,0
8478868,9,76,1,12,13
8479661,18,86,29,19,48
8480890,53,12,4,0,4
8476432,29,589,144,140,284
8475324,15,207,7,39,46
8475324,17,190,6,37,43
8475793,18,468,94,233,327
8475793,29,242,70,102,172
8475149,30,36,6,8,14
8475149,55,51,6,17,23
8475149,15,360,76,142,218
8475149,7,60,9,21,30
8475149,1,77,17,24,41
8475149,6,10,1,2,3
8473446,21,553,60,139,199
8471677,3,13,1,0,1
8471677,21,68,1,7,8
8471677,5,149,4,20,24
8471677,29,424,32,108,140
8477366,30,17,1,0,1
8477366,16,15,0,1,1
8481147,16,32,1,5,6
8474870,14,589,161,200,361
8474870,16,18,1,2,3
8477341,1,115,17,27,44
8477341,10,125,30,37,67
8477527,2,110,8,13,21
8480035,7,167,10,28,38
8480035,16,38,0,12,12
8478452,22,93,5,14,19
8478452,16,46,4,9,13
8479368,24,137,17,11,28
8477495,29,381,50,173,223
8477495,16,68,5,42,47
8477495,18,199,15,48,63
8481708,3,21,0,6,6
8478472,14,221,37,33,70
8478472,9,10,4,7,11
8480058,5,20,1,4,5
8478057,19,37,3,3,6
8474600,18,698,131,386,517
8479370,21,321,45,58,103
8479370,30,13,1,3,4
8479355,23,23,2,1,3
8479355,13,10,0,0,0
8479355,17,5,0,0,0
8476430,54,8,0,1,1
8476430,22,12,0,2,2
8476430,16,42,7,4,11
8476430,17,159,15,24,39
8478454,13,4,0,0,0
8478454,23,8,0,2,2
8478454,8,44,2,6,8
8475172,21,172,56,95,151
8475172,10,510,153,185,338
8480946,22,48,9,6,15
8480946,5,50,10,17,27
8480946,7,6,2,2,4
8480946,16,82,13,24,37
8481554,3,152,24,30,54
8481560,26,73,14,10,24
8480293,16,26,4,5,9
8480144,16,235,17,41,58
8480144,10,72,9,14,23
8474000,6,65,5,8,13
8474000,3,32,1,2,3
8474000,13,73,2,6,8
8475169,28,212,87,79,166
8475169,22,34,16,13,29
8475169,7,196,68,50,118
8475169,52,148,46,50,96
8474141,16,698,300,501,801
8477953,5,112,22,38,60
8477953,10,202,41,49,90
8478864,30,125,69,71,140
8474578,28,209,27,114,141
8474578,9,411,89,280,369
8476448,54,341,106,140,246
8476448,29,165,16,31,47
8476448,24,18,2,1,3
8478436,4,7,1,0,1
8478131,6,9,0,1,1
8478131,10,50,14,13,27
8478131,24,198,43,53,96
8475178,22,403,54,78,132
8475178,23,154,31,25,56
8480822,21,20,2,1,3
8480466,12,2,0,0,0
8481442,13,2,0,0,0
8470281,16,632,49,294,343
8470281,22,55,1,18,19
8479343,53,360,96,160,256
8481516,28,38,4,5,9
8480448,9,32,6,3,9
8477960,26,383,87,93,180
8477021,10,193,29,70,99
8477021,21,157,34,51,85
8478528,25,62,3,10,13
8478528,16,72,8,14,22
8473548,53,198,41,84,125
8473548,5,328,110,193,303
8473548,10,212,82,111,193
8476915,22,258,24,39,63
8476915,16,27,3,0,3
8482641,13,15,1,1,2
8473986,14,713,167,228,395
8481641,25,88,8,10,18
8475906,25,543,71,299,370
8481812,28,59,2,8,10
8476886,22,37,1,4,5
8476886,16,64,2,13,15
8476886,14,85,5,9,14
8469459,29,7,1,1,2
8469459,30,540,97,251,348
8478434,54,116,9,25,34
8473463,2,164,11,37,48
8473463,10,327,52,70,122
8478439,4,418,107,157,264
8471685,26,728,201,426,627
8480011,19,46,5,6,11
8480829,8,171,22,40,62
8480829,12,63,11,15,26
8480833,3,20,2,2,4
8481522,54,13,0,1,1
8481522,7,40,7,12,19
8475184,3,646,226,190,416
8471276,6,585,134,320,454
8476792,19,108,10,57,67
8476792,6,521,67,269,336
8477330,16,194,59,51,110
8480901,6,75,7,8,15
8480901,55,15,2,2,4
8478567,29,149,5,24,29
8476967,8,215,11,34,45
8476967,22,9,1,3,4
8476967,20,101,2,9,11
8475179,1,38,0,2,2
8475179,22,10,0,2,2
8475179,30,69,5,16,21
8475179,52,170,5,22,27
8475179,7,47,2,3,5
8475179,13,262,15,53,68
8479316,18,110,22,17,39
8479316,30,131,23,29,52
8479511,1,99,14,25,39
8479511,12,11,0,0,0
8480845,26,58,6,7,13
8476374,6,270,24,44,68
8476374,29,72,12,16,28
8480798,16,113,14,20,34
8475744,15,589,152,336,488
8478430,20,159,13,30,43
8479385,19,163,42,70,112
8480769,25,33,5,0,5
8478099,28,360,65,118,183
8479550,4,5,0,0,0
8478043,5,94,6,15,21
8478043,16,36,5,3,8
8482109,3,127,27,19,46
8478021,22,57,0,6,6
8478021,8,1,0,0,0
8479339,29,99,35,39,74
8479339,52,306,140,110,250
8477996,13,84,4,7,11
8477996,23,66,7,8,15
8476455,21,656,226,293,519
8477946,17,500,147,210,357
8476457,22,329,16,52,68
8476457,55,72,6,13,19
8476457,1,209,7,44,51
8478491,24,165,3,21,24
8475728,53,81,14,15,29
8475728,15,4,0,1,1
8475728,7,392,38,59,97
8475728,30,1,0,0,0
8476872,4,431,64,91,155
8478468,6,76,3,8,11
8478468,55,53,1,5,6
8478468,18,10,1,0,1
8477508,7,71,10,9,19
8477508,6,77,10,9,19
8477508,20,70,3,12,15
8477508,9,176,12,24,36
8475181,2,518,45,198,243
8475181,17,55,1,15,16
8475181,19,11,2,5,7
8475181,16,130,13,36,49
8475314,2,585,209,152,361
8477476,8,396,74,75,149
8477476,21,6,1,0,1
8482247,29,17,0,3,3
8482247,10,9,0,3,3
8476410,20,38,6,3,9
8476410,12,7,1,2,3
8476410,23,85,17,20,37
8476410,10,84,14,14,28
8477962,3,109,11,20,31
8477962,26,64,10,5,15
8477962,52,53,10,2,12
8481077,28,58,4,11,15
8481105,8,6,0,0,0
8471724,5,583,102,371,473
8479968,24,33,5,4,9
8479968,3,46,2,6,8
8477343,18,2,0,1,1
8477343,6,2,0,0,0
8477343,15,8,1,1,2
8473453,52,56,5,5,10
8473453,20,72,6,9,15
8473453,26,519,63,77,140
8480043,10,65,3,18,21
8479986,23,7,0,0,0
8479986,55,16,1,4,5
8478067,4,254,49,46,95
8476902,25,431,36,103,139
8479324,3,186,6,39,45
8477496,20,279,113,139,252
8477496,12,374,64,124,188
8476854,24,581,57,164,221
8476854,6,7,0,4,4
8480944,6,41,3,3,6
8480944,10,61,1,11,12
8480944,52,4,0,1,1
8480184,17,83,1,15,16
8481481,26,169,17,35,52
8479367,23,9,0,0,0
8479066,13,85,11,10,21
8479066,20,11,0,1,1
8478904,12,106,9,11,20
8476392,52,531,79,87,166
8473473,20,196,28,35,63
8473473,22,243,39,65,104
8473473,26,81,20,35,55
8473473,6,207,49,81,130
8479644,26,64,10,7,17
8479644,18,20,3,3,6
8480806,24,143,22,22,44
8480185,13,112,12,18,30
8480185,12,8,0,1,1
8480950,53,180,1,18,19
8480950,10,21,0,1,1
8476874,26,100,1,10,11
8476874,16,65,4,13,17
8476874,5,362,25,82,107
8477073,26,118,6,11,17
8477073,21,54,2,3,5
8479439,21,40,1,8,9
8479439,13,2,1,0,1
8476907,19,115,11,8,19
8479772,23,55,6,3,9
8479772,4,66,2,5,7
8477974,29,26,0,1,1
8477974,7,1,0,0,0
8482067,20,8,1,2,3
8477492,21,629,236,401,637
8479372,24,73,5,13,18
8477544,15,2,0,0,0
8480069,21,169,45,126,171
8471215,5,550,233,381,614
8477391,18,1,0,1,1
8477391,7,1,0,0,0
8479573,1,33,6,3,9
8479573,21,18,0,0,0
8478233,20,250,73,52,125
8476312,24,453,26,87,113
8476312,21,12,1,2,3
8477511,17,302,95,99,194
8477511,15,41,11,12,23
8473419,6,692,301,389,690
8476539,54,347,120,164,284
8476539,13,75,30,21,51
8476539,14,47,8,11,19
8476539,29,2,0,0,0
8478975,13,80,17,33,50
8478975,10,4,0,1,1
8478507,5,181,10,53,63
8466139,28,490,135,146,281
8466139,5,8,1,1,2
8466139,10,164,43,41,84
8478483,10,418,134,314,448
8474034,14,190,22,42,64
8474034,19,74,10,18,28
8474034,22,154,49,37,86
8474034,1,17,3,10,13
8474034,24,202,26,53,79
8474709,2,521,50,47,97
8474709,10,132,8,13,21
8474166,54,80,11,33,44
8474166,26,482,51,119,170
8476921,12,221,25,37,62
8476921,53,247,26,39,65
8476875,5,110,16,28,44
8476875,13,299,33,58,91
8476870,29,27,3,1,4
8476870,21,1,0,0,0
8476870,54,8,0,1,1
8476870,1,44,3,2,5
8476870,8,12,0,1,1
8479318,10,401,257,193,450
8476429,2,346,19,68,87
8479933,30,17,2,1,3
8479933,4,25,6,0,6
8479933,24,9,2,0,2
8479325,6,304,32,142,174
8476931,7,353,18,59,77
8476931,16,65,3,15,18
8477955,5,141,39,45,84
8477955,55,64,25,16,41
8477955,13,143,18,35,53
8477955,23,69,9,9,18
8477446,18,52,7,7,14
8477446,8,69,2,6,8
8476323,12,12,2,1,3
8476323,55,10,0,0,0
8476323,9,71,6,4,10
8478402,22,479,237,445,682
8474151,14,257,19,76,95
8474151,3,394,43,154,197
8476934,12,345,51,55,106
8476934,5,56,11,7,18
8475735,6,5,1,0,1
8475735,3,94,7,7,14
8475735,12,41,6,5,11
8475735,5,26,2,2,4
8475735,13,46,5,3,8
8475735,14,15,0,1,1
8475735,10,4,0,0,0
8479415,1,152,15,21,36
8480802,22,72,8,11,19
8481580,15,67,9,9,18
8475188,54,329,16,48,64
8475188,26,201,6,36,42
8475188,7,12,0,0,0
8477126,21,35,0,5,5
8477126,23,59,4,4,8
8477126,3,6,1,1,2
8477126,5,48,5,5,10
8478414,28,383,119,139,258
8478467,28,46,2,5,7
8478447,1,31,3,9,12
8478447,28,9,1,2,3
8478447,53,1,0,0,0
8477541,30,5,0,0,0
8477541,1,10,1,3,4
8477541,53,10,0,0,0
8475750,17,36,0,5,5
8475750,8,13,0,0,0
8475750,30,63,4,14,18
8475750,54,140,6,19,25
8475750,1,216,6,30,36
8479376,8,185,4,30,34
8479376,9,49,1,8,9
8482063,23,15,0,0,0
8478136,28,59,3,9,12
8478136,30,10,1,2,3
8479387,21,3,0,0,0
8481624,10,136,30,34,64
8478859,19,87,4,11,15
8477947,24,73,15,21,36
8477947,29,116,20,22,42
8476525,7,137,7,30,37
8476525,54,147,13,57,70
8476525,6,103,9,20,29
8476468,23,193,71,132,203
8476468,14,94,23,42,65
8476468,3,341,72,100,172
8480817,3,126,11,18,29
8476191,6,352,13,58,71
8480070,16,47,3,5,8
8479999,7,187,31,46,77
8477497,20,656,212,250,462
8477986,7,112,13,29,42
8477986,13,83,11,24,35
8477986,24,169,16,47,63
8475186,6,97,6,13,19
8475186,1,217,23,36,59
8475186,3,125,6,21,27
8475186,53,19,1,4,5
8475186,29,17,0,1,1
8479675,26,145,27,45,72
8479675,10,52,5,8,13
8477502,4,29,1,0,1
8477504,52,415,39,123,162
8477353,23,196,28,22,50
8477353,3,9,0,0,0
8477353,29,31,3,2,5
8477353,16,33,4,3,7
8476473,16,293,19,52,71
8476473,53,258,13,36,49
8479419,7,21,2,4,6
8476850,1,48,0,14,14
8476850,21,37,0,4,4
8476850,29,347,15,95,110
8474162,10,180,18,61,79
8474162,26,485,51,161,212
8479026,4,115,6,23,29
8479026,18,27,1,3,4
8474574,23,196,13,45,58
8474574,52,270,29,85,114
8474574,7,148,16,27,43
8476480,17,113,21,21,42
8476480,25,10,1,2,3
8476480,9,54,13,12,25
8476480,21,9,4,2,6
8476480,3,99,13,22,35
8476480,14,263,53,70,123
8474062,29,179,10,23,33
8474062,53,24,0,4,4
8474062,52,15,0,0,0
8474062,14,10,0,0,0
8474062,6,157,22,36,58
8474062,12,237,31,49,80
8471707,22,84,24,17,41
8471707,19,19,2,2,4
8471707,20,63,7,12,19
8471707,54,71,25,19,44
8471707,18,219,77,59,136
8471707,5,99,48,49,97
8480039,12,194,44,70,114
8475754,2,666,201,179,380
8475747,17,103,3,14,17
8475747,21,155,5,22,27
8475747,3,57,2,3,5
8475747,25,108,0,14,14
8474604,53,25,0,1,1
8474604,15,18,0,3,3
8474604,2,20,1,2,3
8476300,20,38,0,4,4
8476300,14,119,8,20,28
8476300,8,13,1,4,5
8481618,21,68,12,19,31
8477501,21,173,42,47,89
8477501,25,223,23,51,74
8475799,12,225,67,65,132
8475799,30,434,110,118,228
8470144,17,319,48,76,124
8470144,2,287,65,117,182
8476442,28,308,38,52,90
8476442,21,251,34,47,81
8478915,52,54,2,8,10
8478915,8,13,0,6,6
8476474,28,39,6,2,8
8476474,10,1,0,0,0
8476474,12,2,0,0,0
8476474,5,6,1,0,1
8476474,1,145,22,21,43
8476474,24,14,2,0,2
8475807,20,44,1,6,7
8475807,6,118,11,8,19
8475807,12,228,19,24,43
8475807,16,54,1,5,6
8480064,9,115,49,34,83
8477931,54,240,31,34,65
8477931,6,66,3,13,16
8477931,17,17,1,0,1
8476454,22,648,177,293,470
8477498,22,472,53,137,190
8478906,13,31,0,11,11
8478906,29,244,17,43,60
8481638,22,42,3,6,9
8477939,10,429,131,200,331
8477070,21,12,0,3,3
8477070,53,37,2,1,3
8477070,15,17,1,1,2
8482055,5,32,3,3,6
8481186,21,115,11,17,28
8475158,19,277,81,158,239
8475158,7,224,65,111,176
8475158,21,191,51,88,139
8477851,53,172,10,34,44
8477851,17,40,2,6,8
8477851,16,55,5,10,15
8477851,22,25,0,6,6
8473449,7,374,77,114,191
8473449,2,258,71,137,208
8476467,25,286,16,31,47
8476467,55,62,1,14,15
8476467,5,83,8,17,25
8479671,18,46,3,4,7
8478109,7,180,53,64,117
8475200,15,575,53,160,213
8471698,15,447,158,163,321
8471698,19,181,47,88,135
8476443,8,37,0,5,5
8476443,17,141,5,18,23
8471214,15,714,436,288,724
8474157,54,215,94,93,187
8474157,8,424,173,161,334
8476419,2,130,31,34,65
8476419,9,428,87,95,182
8476292,14,618,141,272,413
8475151,1,397,140,126,266
8475151,2,75,16,17,33
8475151,24,170,38,43,81
8478550,3,179,70,171,241
8478550,29,160,55,114,169
8478550,16,162,61,90,151
8475209,15,95,12,19,31
8475209,17,12,1,3,4
8475209,2,4,0,1,1
8475209,53,110,22,30,52
8475209,16,149,34,34,68
8475209,10,76,11,6,17
8475209,14,75,8,14,22
8476975,12,38,3,4,7
8476975,9,9,1,0,1
8476975,8,24,0,2,2
8476975,14,377,47,38,85
8476892,19,488,47,153,200
8470610,30,558,199,201,400
8470610,2,71,11,18,29
8482369,28,4,0,0,0
8477956,6,507,238,260,498
8474688,21,8,0,0,0
8474688,30,103,1,11,12
8474688,28,2,0,1,1
8474688,24,10,1,1,2
8474688,25,85,1,15,16
8474688,8,82,2,11,13
8479974,4,197,30,40,70
8479974,54,25,2,5,7
8477426,9,227,29,37,66
8477426,14,11,2,5,7
8470794,25,195,66,88,154
8470794,28,532,221,235,456
8476871,23,207,54,55,109
8476871,5,44,9,5,14
8476871,26,325,69,75,144
8476285,9,14,0,3,3
8476285,19,5,0,1,1
8476285,8,44,3,7,10
8476285,14,20,3,4,7
8478967,53,15,1,2,3
8478967,28,28,0,2,2
8479369,29,106,2,18,20
8476917,2,370,19,83,102
8473618,52,455,88,142,230
8473618,8,20,3,3,6
8473618,24,69,18,25,43
8473618,15,39,6,11,17
8474102,19,372,118,167,285
8474102,54,70,16,50,66
8474102,5,86,16,22,38
8474102,24,28,8,12,20
8474102,22,116,33,43,76
8470621,8,49,9,12,21
8470621,14,72,17,18,35
8470621,25,57,5,16,21
8470621,24,458,167,180,347
8477488,12,466,31,121,152
8477464,10,28,1,4,5
8477464,23,13,0,1,1
8477464,52,108,5,18,23
8473507,8,499,68,171,239
8473507,22,187,14,30,44
8480012,23,236,90,119,209
8477969,5,239,7,59,66
8477969,24,49,1,9,10
8479547,20,1,0,0,0
8474565,54,112,20,43,63
8474565,19,581,85,268,353
8479516,15,3,1,0,1
8477314,15,2,0,0,0
8481596,9,17,1,7,8
8480145,52,194,12,96,108
8480145,3,101,7,33,40
8475204,16,30,6,5,11
8475204,54,49,15,8,23
8475204,3,60,8,10,18
8475204,13,122,40,22,62
8475204,24,9,3,2,5
8479514,18,11,0,2,2
8479514,8,37,7,15,22
8479514,30,20,6,5,11
8475752,53,38,6,5,11
8475752,20,25,0,2,2
8475752,8,6,0,1,1
8475752,4,63,8,12,20
8475752,25,127,22,17,39
8475752,22,58,11,3,14
8478040,19,6,0,0,0
8478040,52,16,0,0,0
8478010,14,409,166,199,365
8477359,52,120,5,14,19
8477359,23,40,1,2,3
8475613,4,6,1,1,2
8475613,30,297,9,25,34
8475613,19,1,0,0,0
8478500,4,440,58,126,184
8479344,22,253,45,51,96
8477506,2,336,36,105,141
8475796,25,36,3,1,4
8475796,7,192,8,30,38
8475796,13,292,17,45,62
8471228,25,288,79,132,211
8471228,8,76,18,36,54
8481479,23,3,0,1,1
8477290,4,504,81,79,160
8477290,15,10,1,2,3
8477290,25,66,6,9,15
8476483,24,550,154,185,339
8476483,5,11,3,5,8
8478420,21,402,164,238,402
8476437,30,149,22,30,52
8476437,55,8,1,1,2
8476437,12,339,63,100,163
8479992,17,172,23,30,53
8480056,23,17,1,2,3
8476415,30,28,0,4,4
8476415,13,33,2,1,3
8471817,54,209,18,24,42
8471817,3,61,3,8,11
8471817,5,58,4,4,8
8471817,19,331,22,21,43
8480831,16,9,0,0,0
8476422,9,70,1,30,31
8476422,6,78,4,19,23
8476422,8,90,3,20,23
8476422,30,84,4,14,18
8477933,7,454,134,161,295
8477933,13,69,27,44,71
8480776,12,3,0,0,0
8480776,23,1,0,0,0
8480776,26,7,0,0,0
8479252,21,18,0,3,3
8479252,17,5,0,0,0
8479462,3,4,0,1,1
8482179,3,1,0,1,1
8470755,18,17,1,3,4
8470755,20,27,2,2,4
8470755,23,126,20,26,46
8470755,53,299,44,49,93
8470755,26,16,1,5,6
8476356,7,44,5,2,7
8476356,20,55,4,6,10
8476356,22,67,0,11,11
8476356,53,292,51,60,111
8476356,26,20,4,2,6
8476853,10,644,69,297,366
8480945,5,80,3,10,13
8474736,20,23,3,2,5
8474736,18,23,1,2,3
8474736,53,53,5,2,7
8474736,6,52,1,2,3
8474736,4,157,6,9,15
8477499,7,542,46,199,245
8477499,4,65,2,14,16
8476439,20,66,6,4,10
8476439,6,27,2,4,6
8476439,25,241,33,21,54
8477941,6,63,16,12,28
8477941,10,33,2,7,9
8477941,53,20,8,3,11
8477941,24,287,43,66,109
8480027,25,118,51,62,113
8481582,10,15,1,1,2
8477210,20,14,1,0,1
8477210,24,30,1,5,6
8477210,9,7,1,1,2
8480762,29,178,24,31,55
8478542,5,116,26,31,57
8478542,7,192,26,45,71
8481014,8,124,4,14,18
8479291,3,106,14,11,25
8479291,1,95,10,9,19
8478458,29,120,27,43,70
8478458,52,180,26,41,67
8474849,23,141,17,31,48
8474849,53,47,3,3,6
8474849,25,413,64,77,141
8477240,24,152,15,30,45
8477240,17,26,4,2,6
8477240,5,71,5,7,12
8478911,26,199,9,42,51
8478462,54,147,24,34,58
8478462,12,7,0,0,0
8477244,5,224,10,25,35
8477244,7,33,0,2,2
8481626,7,35,7,3,10
8471729,22,332,8,65,73
8471729,20,198,15,63,78
8471729,25,11,0,4,4
8471729,19,33,1,6,7
8479466,22,59,0,7,7
8475810,5,416,124,146,270
8480172,14,150,4,30,34
8480172,16,80,8,18,26
8480008,20,28,5,5,10
8471676,17,33,7,7,14
8471676,9,455,107,159,266
8471676,24,46,11,19,30
8478585,20,192,25,55,80
8478585,22,66,8,11,19
8478585,12,153,28,41,69
8477046,12,4,0,0,0
8477046,26,35,1,4,5
8477046,28,106,3,16,19
8480221,26,1,0,0,0
8476438,21,44,15,9,24
8476438,19,68,20,23,43
8476438,16,426,114,127,241
8476438,29,160,55,51,106
8477149,10,1,0,0,0
8477149,9,39,2,4,6
8480807,7,47,0,11,11
8480873,10,88,6,22,28
8477482,19,183,36,35,71
8477482,9,62,9,8,17
8477482,52,11,0,3,3
8477482,15,26,2,1,3
8477948,4,325,29,85,114
8477463,19,3,0,1,1
8477463,18,2,0,0,0
8477463,1,114,5,16,21
8475233,29,566,39,117,156
8475233,14,14,0,0,0
8475233,8,53,3,11,14
8474579,18,1,0,0,0
8474579,52,44,2,8,10
8474579,2,9,0,1,1
8474579,54,30,2,12,14
8474579,23,199,7,25,32
8474579,24,71,2,12,14
8474618,19,121,5,17,22
8474618,7,176,14,30,44
8474618,8,20,1,2,3
8474618,30,290,24,51,75
8474098,5,46,5,5,10
8474098,22,35,2,3,5
8474098,13,284,31,48,79
8474098,25,169,28,34,62
8476460,52,635,229,347,576
8475170,19,337,107,162,269
8475170,4,370,97,131,228
8474568,14,63,3,4,7
8474568,23,75,4,13,17
8474568,24,8,0,0,0
8474568,53,142,2,13,15
8474568,26,43,2,9,11
8474568,4,213,12,30,42
8477951,53,192,48,93,141
8477951,16,162,29,62,91
8477220,23,54,5,10,15
8477220,52,70,4,28,32
8477220,54,196,21,76,97
8477220,15,200,8,35,43
8474602,15,110,5,37,42
8474602,5,234,22,91,113
8474602,22,248,28,73,101
8475768,19,553,152,230,382
8475768,55,37,8,15,23
8475794,25,612,247,314,561
8475794,6,48,16,16,32
8471284,25,134,6,11,17
8471284,22,221,14,63,77
8471284,12,131,13,50,63
8471284,26,16,1,3,4
8471284,7,37,2,10,12
8478485,6,14,1,2,3
8479410,14,348,35,135,170
8479410,8,4,0,0,0
8476923,1,556,50,175,225
8475958,15,17,2,4,6
8475958,13,29,2,5,7
8475958,24,10,0,2,2
8475958,21,9,0,1,1
8481068,1,120,36,34,70
8474031,24,129,10,37,47
8474031,14,70,8,26,34
8474031,3,119,7,44,51
8474031,19,318,48,150,198
8474031,15,19,2,12,14
8476381,16,325,63,65,128
8476381,8,182,41,55,96
8475772,7,53,4,9,13
8475772,55,59,2,11,13
8475772,22,66,8,7,15
8475772,5,122,18,23,41
8475772,13,33,2,8,10
8475772,17,291,38,60,98
8477839,15,114,30,28,58
8477839,7,133,23,30,53
8477839,5,192,49,48,97
8480748,21,27,1,4,5
8480748,24,60,6,7,13
8478949,29,11,0,1,1
8478949,18,1,0,0,0
8476913,22,84,10,10,20
8476913,24,73,9,13,22
8476913,29,6,1,1,2
8476913,25,209,29,53,82
8475213,12,4,0,0,0
8475213,23,14,0,2,2
8475213,20,13,1,3,4
8475213,13,67,8,12,20
8478399,1,78,1,13,14
8478399,15,97,2,11,13
8478106,54,6,2,0,2
8478106,21,5,0,1,1
8478106,16,47,1,13,14
8475164,24,610,141,168,309
8475164,9,48,10,9,19
8480160,28,164,6,20,26
8474190,10,103,12,12,24
8474190,1,61,8,16,24
8474190,7,7,0,1,1
8474190,4,502,175,154,329
8474190,18,17,1,2,3
8478866,20,11,0,0,0
8478866,5,228,22,51,73
8478866,24,9,0,3,3
8476925,18,445,60,74,134
8475784,7,266,91,63,154
8475784,12,433,153,119,272
8476869,12,132,11,30,41
8476869,3,307,25,87,112
8476958,12,500,35,169,204
8474090,3,235,14,29,43
8474090,12,38,3,2,5
8474090,17,277,14,46,60
8480083,7,14,2,1,3
8480083,12,1,0,0,0
8482062,18,9,0,0,0
8475225,6,118,29,35,64
8475225,18,589,148,146,294
8476966,14,8,1,3,4
8476966,17,3,0,1,1
8476966,25,77,11,9,20
8476966,6,3,0,0,0
8479379,17,83,7,7,14
8475191,54,321,98,132,230
8475191,13,162,40,47,87
8475191,6,163,33,58,91
8475191,25,37,3,6,9
8480883,1,107,7,35,42
8471262,16,34,7,8,15
8471262,21,332,57,96,153
8471262,53,70,17,18,35
8471262,6,161,29,65,94
8481599,53,17,1,1,2
8475834,28,226,31,33,64
8477369,30,108,8,23,31
8477369,55,54,9,10,19
8469455,10,175,29,47,76
8469455,25,379,81,147,228
8469455,9,80,25,46,71
8478466,15,89,21,13,34
8478466,55,9,3,0,3
8478466,24,55,15,6,21
8478466,5,42,4,5,9
8474716,30,640,89,217,306
8470595,7,32,3,7,10
8470595,8,21,2,1,3
8470595,30,311,111,129,240
8470595,12,267,72,129,201
8470595,3,20,3,3,6
8473533,12,654,134,224,358
8471686,17,119,6,20,26
8471686,3,525,21,81,102
8474564,14,587,292,325,617
8479378,52,92,2,15,17
8471669,52,138,37,45,82
8471669,54,121,30,50,80
8471669,19,267,56,119,175
8471669,21,111,34,50,84
8479442,17,60,4,9,13
8479442,26,10,0,0,0
8479442,23,286,11,64,75
8479351,24,190,24,39,63
8479546,6,22,2,4,6
8478831,29,71,11,9,20
8474613,9,20,1,5,6
8474613,12,54,8,8,16
8474613,53,224,39,80,119
8474613,3,351,90,174,264
8478477,14,45,3,4,7
8478477,17,17,0,5,5
8476905,54,162,39,75,114
8476905,15,168,14,19,33
8479388,16,57,2,10,12
8479388,13,43,0,5,5
8475913,54,166,55,108,163
8475913,9,366,123,188,311
8474628,20,178,11,26,37
8474628,53,311,23,70,93
8471873,13,107,8,20,28
8471873,53,64,5,12,17
8471873,14,355,29,101,130
8471873,3,129,5,15,20
8480467,26,21,0,3,3
8478440,16,215,58,91,149
8478440,53,48,7,9,16
8476458,3,254,67,121,188
8476458,22,100,14,22,36
8476458,2,258,45,81,126
8480226,1,25,2,1,3
8480226,25,10,1,2,3
8480021,6,36,1,6,7
8481477,30,111,20,16,36
8481477,21,11,0,2,2
8482116,9,122,27,46,73
8474056,1,181,17,41,58
8474056,18,211,35,95,130
8474056,8,274,42,160,202
8476897,19,242,35,48,83
8476897,17,10,2,2,4
8476897,5,28,1,3,4
8480965,28,51,4,11,15
8480201,4,2,0,0,0
8480459,16,55,14,13,27
8480459,17,72,13,19,32
8470600,30,656,55,314,369
8470600,25,72,7,24,31
8474091,23,275,54,50,104
8474091,5,209,45,33,78
8480018,8,200,47,90,137
8480830,12,275,87,117,204
8478431,17,41,5,7,12
8478431,52,64,7,12,19
8479293,5,100,18,23,41
8479293,55,30,9,6,15
8479293,52,195,24,27,51
8475690,20,128,7,29,36
8475690,23,460,22,93,115
8475765,19,596,244,263,507
8475193,8,198,57,92,149
8475193,1,69,14,15,29
8475193,17,398,114,107,221
8475193,54,20,4,2,6
8475166,10,272,118,149,267
8475166,2,426,188,231,419
8476807,1,41,1,5,6
8476807,18,8,0,3,3
8476807,7,19,0,0,0
8476807,12,45,0,6,6
8476807,28,60,3,11,14
8476882,12,402,98,220,318
8476882,16,115,17,27,44
8478873,24,196,47,59,106
8480074,29,123,22,27,49
8477447,54,333,50,146,196
8477447,24,53,5,12,17
8478049,14,5,0,0,0
8480023,19,231,40,112,152
8470775,52,44,2,3,5
8470775,4,31,1,3,4
8470775,8,88,5,16,21
8470775,26,79,5,7,12
8470775,9,43,4,7,11
8470775,24,159,9,17,26
8470775,14,126,16,15,31
8479420,7,174,47,37,84
8479420,19,41,3,6,9
8481740,1,9,0,1,1
8466138,10,44,5,15,20
8466138,13,30,5,4,9
8466138,28,559,96,335,431
8476919,9,268,32,89,121
8476919,28,284,41,63,104
8478857,2,1,0,0,0
8478857,10,39,4,5,9
8478857,17,5,0,0,0
8479982,21,33,0,7,7
8479982,53,6,0,0,0
8475797,6,14,0,1,1
8475797,18,35,1,4,5
8475797,3,7,1,0,1
8475797,53,7,0,0,0
8475797,8,46,0,6,6
8480015,13,94,14,19,33
8480015,4,11,2,1,3
8480801,9,267,86,95,181
8479314,20,421,144,223,367
8478038,21,114,22,63,85
8478038,2,116,11,35,46
8475726,8,89,37,33,70
8475726,20,27,11,9,20
8475726,26,515,139,151,290
8475726,23,10,6,4,10
8480009,18,115,21,24,45
8476952,52,71,6,7,13
8476952,13,46,4,7,11
8476952,21,39,1,2,3
8478508,18,136,24,17,41
8476389,12,127,37,55,92
8476389,13,420,111,171,282
8476885,3,181,19,55,74
8476885,52,408,42,137,179
8480384,28,19,0,5,5
8480384,55,8,0,0,0
8477949,54,249,61,78,139
8477949,7,42,10,23,33
8477949,30,6,0,0,0
8474068,22,50,3,6,9
8474068,18,182,29,67,96
8474068,9,358,105,140,245
8479358,4,22,1,0,1
8480001,6,31,0,6,6
8480001,24,7,0,2,2
8479976,20,82,3,13,16
8474037,4,260,81,81,162
8474037,10,413,154,140,294
8477845,15,82,2,15,17
8477845,12,206,7,31,38
8477845,16,158,8,23,31
8475222,1,184,14,60,74
8475222,25,9,0,0,0
8475222,24,280,33,93,126
8478366,13,271,73,53,126
8478366,3,13,6,3,9
8478366,6,108,20,11,31
8480813,17,61,8,7,15
8477409,13,114,40,48,88
8477409,14,52,9,4,13
8480005,52,70,2,3,5
8476918,10,30,5,2,7
8476918,23,20,0,3,3
8476918,1,66,7,7,14
8476918,7,64,9,11,20
8476918,3,240,50,40,90
8479705,28,41,3,2,5
8480014,26,85,16,17,33
8477937,23,317,55,45,100
8471709,28,679,54,159,213
8480186,14,28,3,3,6
8480186,24,18,4,4,8
8474161,4,649,159,396,555
8474161,29,70,5,47,52
8477944,15,284,76,81,157
8477944,17,27,18,7,25
8478455,26,171,22,18,40
8475780,6,184,20,14,34
8475780,24,133,12,12,24
8475780,2,15,1,0,1
8475780,21,26,4,0,4
8480789,2,118,25,20,45
8478069,14,1,0,0,0
8477573,19,33,9,2,11
8477573,15,10,1,1,2
8477573,22,2,0,0,0
8480336,26,162,13,41,54
8478027,16,16,0,3,3
8478027,13,11,1,1,2
8478027,12,160,22,32,54
8478013,19,57,4,4,8
8478013,17,9,0,2,2
8475766,9,91,10,10,20
8475766,18,306,36,41,77
8470642,8,275,58,88,146
8470642,18,283,67,113,180
8474134,5,2,0,0,0
8474134,18,223,6,18,24
8474134,23,159,17,21,38
8474134,8,6,0,2,2
8477346,13,298,26,92,118
8476407,24,46,1,5,6
8477505,13,56,17,12,29
8477505,55,70,10,23,33
8477505,29,415,40,161,201
8478460,29,399,76,160,236
8471218,52,714,217,453,670
8478400,9,222,36,62,98
8478841,1,36,0,4,4
8480727,54,118,9,20,29
8476880,15,637,114,157,271
8478846,9,58,5,13,18
8478846,26,11,1,1,2
8478846,7,1,0,0,0
8477425,1,326,65,56,121
8479977,22,177,38,49,87
8471735,13,371,30,201,231
8471735,4,68,1,14,15
8471735,3,103,7,51,58
8471735,53,193,22,102,124
8481058,8,15,2,3,5
8481546,4,32,3,7,10
8478401,1,376,68,104,172
8480821,17,155,24,34,58
8477507,16,55,1,7,8
8477507,20,64,3,13,16
8477507,21,289,18,41,59
8477507,7,67,4,12,16
8479458,9,166,7,30,37
8479458,10,223,12,51,63
8471233,1,601,111,184,295
8471233,2,13,1,1,2
8481178,4,3,0,0,0
8478415,6,54,0,12,12
8481533,24,91,23,44,67
8476459,3,396,163,194,357
8476459,9,272,64,86,150
8482241,5,25,4,6,10
8482245,9,119,9,26,35
8475692,30,170,48,96,144
8475692,3,457,105,221,326
8475692,25,2,1,2,3
8475722,5,87,22,23,45
8475722,30,450,132,109,241
8481720,10,3,0,0,0
8480823,15,1,0,0,0
8481521,4,5,1,1,2
8477631,8,1,0,0,0
8476466,54,1,0,0,0
8476466,23,225,58,52,110
8476466,20,61,5,20,25
8477003,17,2,0,0,0
8477003,8,9,0,0,0
8477003,15,3,0,0,0
8482111,8,5,1,1,2
8482111,21,2,0,0,0
8481550,30,3,0,1,1
8479347,22,36,1,2,3
8482061,7,1,0,0,0
8479512,5,6,1,0,1
8481557,30,36,13,16,29
8479404,16,46,4,3,7
8479404,13,58,9,10,19
8470619,5,60,10,7,17
8470619,13,39,6,9,15
8470619,1,116,26,16,42
8470619,18,26,5,0,5
8470619,14,212,41,25,66
8470619,10,21,0,3,3
8470619,3,120,8,15,23
8481598,22,22,0,2,2
8479619,53,12,2,1,3
8480220,4,6,2,0,2
8482475,29,58,7,7,14
8480990,52,2,0,0,0
8481161,29,8,1,0,1
8481032,54,7,2,0,2
8479304,17,4,0,2,2
8479304,7,9,0,0,0
8479373,28,55,12,10,22
8477472,10,2,0,1,1
8477472,52,15,0,1,1
8477472,16,49,0,9,9
8480988,25,7,1,1,2
8479941,29,36,9,2,11
8477460,8,35,4,8,12
8477460,53,35,3,1,4
8479413,14,2,0,0,0
8480980,30,30,2,3,5
8479341,53,26,0,7,7
8481604,54,2,0,0,0
8480835,12,2,2,0,2
8482652,20,1,0,0,0
8479520,30,69,6,10,16
8480434,26,56,3,23,26
8482667,28,9,0,4,4
8477461,14,1,0,0,0
8477461,7,16,0,1,1
8477461,25,90,7,14,21
8481239,26,4,0,0,0
8480796,15,75,7,8,15
8479578,7,29,0,4,4
8480441,29,6,1,1,2
8479985,55,5,0,0,0
8479985,8,41,1,0,1
8480863,14,10,1,0,1
8482834,6,5,0,0,0
8480231,16,6,0,0,0
8476867,29,23,5,2,7
8476867,6,1,0,1,1
8476867,23,117,6,9,15
8477419,1,24,0,0,0
8476878,7,537,71,83,154
8479447,3,1,0,0,0
8479447,13,1,0,0,0
8476495,22,1,0,0,0
8476495,7,21,2,1,3
8476495,13,21,0,5,5
8476495,10,3,0,0,0
8476495,6,34,6,5,11
8480870,24,18,1,2,3
8478425,24,42,4,5,9
8478425,7,23,0,5,5
8480304,28,3,0,1,1
8480842,5,1,0,0,0
8481581,25,29,0,2,2
8480887,8,4,0,0,0
8481093,8,3,1,0,1
8481701,28,8,0,2,2
8481849,54,3,0,0,0
8477471,9,9,0,0,0
8477471,25,11,0,2,2
8480858,8,1,0,0,0
8478173,4,6,1,2,3
8476345,29,24,2,5,7
8482125,1,7,0,2,2
8480306,2,13,1,0,1
8482093,12,59,13,18,31
8476436,53,12,0,1,1
8476436,15,37,2,6,8
8476436,19,266,25,36,61
8479321,15,1,0,1,1
8480259,54,2,0,0,0
8479536,15,21,1,2,3
8480355,9,11,0,2,2
8479383,14,38,2,4,6
8479383,16,11,1,0,1
8479482,15,166,12,36,48
8479482,16,81,3,12,15
8481815,24,1,0,0,0
8481552,28,1,0,0,0
8479526,2,17,0,1,1
8481609,53,26,1,2,3
8481527,54,1,0,0,0
8480192,52,4,0,0,0
8476453,14,552,236,357,593
8471217,53,45,6,3,9
8471217,2,181,39,33,72
8471217,52,266,82,114,196
8471217,16,19,8,4,12
8476983,2,1,0,0,0
8476983,26,69,5,13,18
8479320,12,5,0,0,0
8479320,9,62,7,8,15
8482148,15,6,1,0,1
8481517,15,36,3,3,6
8479991,54,36,2,4,6
8476989,13,6,0,0,0
8476989,19,40,2,1,3
8481489,30,1,0,0,0
8482113,13,57,16,25,41
8480878,3,25,1,3,4
8481711,53,19,1,4,5
8479359,15,15,1,0,1
8474089,22,31,1,1,2
8474089,12,122,9,12,21
8474089,21,45,4,3,7
8482408,52,1,0,0,0
8479553,13,66,8,6,14
8478442,22,7,0,1,1
8478062,53,63,4,8,12
8481827,53,2,0,0,0
8483397,6,4,1,0,1
8482745,24,9,2,1,3
8477034,28,34,1,3,4
8477034,24,43,1,4,5
8482110,1,72,16,25,41
8480847,28,30,1,4,5
8480292,29,4,1,1,2
8482624,54,11,0,1,1
8482655,53,33,3,9,12
8479421,26,14,0,1,1
8482089,19,9,1,1,2
8479338,22,20,0,1,1
8481555,8,6,0,1,1
8478438,18,27,1,6,7
8474679,29,143,32,54,86
8474679,17,463,124,164,288
8474679,28,19,6,5,11
8476982,24,5,0,1,1
8476982,7,3,0,0,0
8476982,28,22,1,4,5
8481167,54,2,0,0,0
8478486,17,1,0,0,0
8482149,52,18,2,5,7
8477943,22,23,4,1,5
8477943,17,39,1,3,4
8477943,16,47,12,3,15
8477943,53,153,33,24,57
8482150,24,1,0,0,0
8481059,19,19,0,6,6
8482175,7,2,0,0,0
8480216,25,59,12,5,17
8479543,8,45,5,3,8
8482192,16,4,0,0,0
8481617,23,70,10,9,19
8480068,8,77,9,9,18
8479249,12,4,0,2,2
8476884,55,5,0,1,1
8476884,54,2,0,1,1
8476884,19,2,0,0,0
8476884,23,133,6,28,34
8476884,5,67,2,12,14
8479597,13,4,0,0,0
8481656,15,33,3,6,9
8479289,7,4,1,0,1
8481703,5,1,0,1,1
8482097,7,2,1,1,2
8478178,14,4,0,0,0
8479390,14,53,5,7,12
8479390,16,11,2,3,5
8480846,21,10,0,0,0
8482197,28,5,0,0,0
8480019,4,10,1,3,4
8482078,17,72,22,32,54
8480060,28,24,2,1,3
8480443,52,13,1,1,2
8482117,16,7,0,0,0
8481133,9,1,0,0,0
8480157,19,13,0,4,4
8480157,21,8,0,2,2
8480157,10,12,1,2,3
8482079,30,2,0,0,0
8479729,10,3,0,0,0
8480007,54,30,2,4,6
8480071,2,18,1,3,4
8480049,52,9,0,4,4
8480041,22,1,0,0,0
8482243,4,1,0,0,0
8482073,3,34,2,7,9
8481461,8,22,2,4,6
8481655,13,1,0,0,0
8476372,4,43,1,2,3
8476372,16,6,0,1,1
8476372,30,99,2,9,11
8481542,17,72,5,40,45
8482815,10,3,0,0,0
8478881,10,2,0,0,0
8478881,1,53,5,8,13
8476400,9,17,1,2,3
8476400,52,35,3,2,5
8476400,24,97,5,13,18
8476400,8,30,2,4,6
8476400,13,53,5,2,7
8479972,30,3,0,0,0
8482705,29,70,12,12,24
8481004,16,15,0,1,1
8481441,15,12,4,3,7
8481102,9,8,0,0,0
8478480,53,2,0,0,0
8478480,1,3,0,0,0
8481606,26,16,1,4,5
8482634,10,3,0,1,1
8478058,52,4,0,0,0
8477205,24,20,0,3,3
8477205,14,333,11,53,64
8481575,9,16,0,5,5
8478250,26,4,0,2,2
8473604,16,643,212,309,521
8481577,18,66,11,17,28
8480281,19,22,2,0,2
8481530,24,1,0,0,0
8479362,25,10,1,0,1
8481532,26,8,0,0,0
8476391,26,2,0,0,0
8476391,21,16,0,1,1
8476391,29,3,0,0,0
8480087,15,1,0,0,0
8480087,4,2,0,0,0
8478838,8,13,2,0,2
8481568,16,5,0,0,0
8481061,28,45,4,6,10
8475227,8,57,4,21,25
8475227,9,175,16,27,43
8475227,22,5,0,2,2
8475227,13,1,0,0,0
8478051,4,41,4,2,6
8474722,17,66,1,5,6
8474722,14,66,1,6,7
8480188,1,5,0,2,2
8471716,17,530,88,117,205
8476857,10,5,0,1,1
8476857,24,37,11,8,19
8476857,30,22,1,5,6
8476857,18,52,3,7,10
8476857,22,16,2,6,8
8473991,8,95,1,12,13
8473991,15,376,15,63,78
8474717,21,113,6,19,25
8474717,8,56,2,12,14
8474717,14,103,6,11,17
8478367,2,10,1,1,2
8478833,9,22,0,1,1
8476987,54,4,0,0,0
8477010,5,27,2,3,5
8477010,24,6,0,0,0
8477010,1,68,8,18,26
8474571,9,91,9,30,39
8474571,28,155,25,38,63
8474571,53,237,53,91,144
8474571,21,18,4,8,12
8475268,52,52,2,4,6
8475268,21,119,7,12,19
8475268,18,199,24,35,59
8470151,19,490,17,107,124
8470151,20,33,6,9,15
8470187,2,404,35,96,131
8470187,6,119,6,23,29
8471426,19,95,19,21,40
8471426,13,75,12,9,21
8471426,20,150,19,28,47
8471426,15,211,65,54,119
8474008,6,3,0,0,0
8474008,9,5,0,0,0
8474008,3,60,7,7,14
8474008,15,10,1,0,1
8474008,21,22,0,1,1
8476953,28,3,0,0,0
8476953,12,4,0,0,0
8477529,22,44,3,1,4
8477529,6,23,1,4,5
8477417,6,40,5,6,11
8481642,52,2,0,0,0
8476195,14,87,18,23,41
8476195,2,15,1,2,3
8476195,9,72,6,19,25
8476195,7,19,3,3,6
8470110,17,164,11,20,31
8470110,5,109,11,30,41
8470110,16,29,0,6,6
8470110,25,179,29,47,76
8477448,29,38,8,13,21
8477448,21,8,0,0,0
8477448,52,82,10,12,22
8477448,16,13,1,1,2
8480247,9,6,0,1,1
8476974,5,2,0,0,0
8475254,30,3,0,0,0
8475254,9,23,1,1,2
8475254,14,46,2,2,4
8475254,8,15,1,2,3
8478036,17,114,5,8,13
8468674,54,202,8,33,41
8468674,20,226,9,30,39
8468674,5,98,6,12,18
8477971,9,33,0,3,3
8470318,17,448,17,64,81
8480147,23,36,1,5,6
8480147,26,73,4,8,12
8480147,20,15,0,1,1
8476166,25,81,6,14,20
8476166,7,34,0,8,8
8476166,23,1,0,1,1
8476166,28,7,0,4,4
8476166,22,4,2,0,2
8475907,23,14,1,4,5
8475907,12,71,17,23,40
8475907,20,250,42,47,89
8477850,8,35,1,5,6
8477850,4,26,0,2,2
8477850,26,65,3,10,13
8477850,30,118,4,19,23
8474611,14,5,1,3,4
8474611,5,12,1,3,4
8474611,25,9,0,0,0
8476207,12,15,0,0,0
8476207,24,44,2,3,5
8476207,9,20,6,8,14
8476207,1,59,12,14,26
8476207,29,25,0,5,5
8476207,5,41,5,12,17
8477337,7,4,0,0,0
8477337,3,33,2,3,5
8477958,23,114,18,26,44
8477958,28,11,1,1,2
8474597,9,29,1,1,2
8474597,17,2,0,0,0
8474597,21,33,0,5,5
8474597,29,95,2,16,18
8473546,53,87,17,10,27
8473546,3,135,52,19,71
8473546,1,21,2,3,5
8473546,10,80,9,9,18
8473546,2,143,36,24,60
8476440,22,34,3,1,4
8476440,23,215,41,28,69
8476440,20,86,14,14,28
8475857,10,3,0,0,0
8475857,22,36,0,3,3
8475857,26,70,1,9,10
8471242,17,303,37,104,141
8471242,22,2,0,0,0
8471242,15,177,31,78,109
8468493,9,64,1,11,12
8468493,10,161,9,37,46
8468493,12,300,15,43,58
8468493,5,16,0,3,3
8468493,52,47,0,13,13
8469465,18,117,0,13,13
8469465,25,159,4,36,40
8469465,23,243,13,69,82
8475841,28,105,6,23,29
8478176,17,22,0,5,5
8473560,24,145,4,14,18
8473560,18,3,0,0,0
8473560,10,56,2,7,9
8476948,8,125,14,27,41
8477972,1,3,0,0,0
8475730,25,167,15,18,33
8480341,5,13,1,3,4
8477973,21,64,3,10,13
8477973,18,2,0,0,0
8477922,28,396,60,52,112
8476472,22,378,34,122,156
8479510,10,1,1,0,1
8469454,8,22,6,7,13
8469454,26,81,19,24,43
8469454,15,7,1,3,4
8469454,1,37,11,20,31
8475832,2,64,7,8,15
8475832,5,168,11,28,39
8474873,17,136,2,13,15
8476894,15,61,3,8,11
8476894,26,45,5,13,18
8476894,23,31,5,9,14
8476894,54,44,2,11,13
8476894,10,6,1,2,3
8473914,52,7,0,0,0
8473914,29,204,33,45,78
8473914,22,220,34,45,79
8477983,28,3,1,0,1
8481650,29,37,2,3,5
8478073,21,66,0,5,5
8473412,52,487,125,201,326
8481649,52,16,0,0,0
8478843,13,184,28,32,60
8478843,10,8,0,0,0
8475430,22,21,2,0,2
8475430,16,27,1,2,3
8475430,4,203,11,32,43
8475716,10,142,4,19,23
8475716,22,85,1,10,11
8475795,17,23,0,0,0
8475795,13,5,1,0,1
8475795,3,38,2,2,4
8479734,30,5,0,0,0
8477509,1,131,3,19,22
8477509,28,54,2,4,6
8476922,3,76,5,14,19
8471702,4,68,8,25,33
8471702,15,390,29,127,156
8471702,5,121,14,46,60
8479423,16,65,10,16,26
8479423,7,19,3,3,6
8477467,8,3,0,0,0
8477467,30,56,0,11,11
8480940,22,13,0,2,2
8480935,7,46,1,5,6
8471392,25,118,1,12,13
8471392,10,240,12,33,45
8471392,28,24,0,3,3
8471392,19,120,5,14,19
8476947,26,43,4,10,14
8474774,28,2,0,0,0
8474774,20,20,1,1,2
8474774,1,18,0,3,3
8474774,29,219,6,27,33
8477961,16,9,0,0,0
8477961,1,33,2,3,5
8476409,20,22,4,2,6
8476409,2,84,6,16,22
8479748,54,3,0,1,1
8480780,28,50,7,4,11
8478409,18,2,0,0,0
8479424,4,4,0,0,0
8478839,13,9,2,2,4
8476447,18,167,12,15,27
8477085,23,23,0,3,3
8477213,23,98,8,8,16
8477213,26,2,0,0,0
8477213,6,141,19,17,36
8477213,7,35,2,3,5
8470607,16,562,55,183,238
8476406,52,42,1,2,3
8476406,10,21,2,1,3
8476406,26,221,14,35,49
8476406,20,9,1,2,3
8476406,9,6,0,1,1
8475748,7,1,0,0,0
8474250,16,50,4,7,11
8474250,9,460,74,81,155
8471743,7,85,6,10,16
8471743,19,191,29,55,84
8470257,19,521,130,216,346
8473485,4,16,0,1,1
8473485,30,146,25,20,45
8473485,20,7,1,2,3
8473485,24,56,8,12,20
8473485,7,66,11,14,25
8473485,19,106,33,29,62
8476043,1,3,0,1,1
8476043,24,21,3,2,5
8476043,17,6,0,1,1
8476043,21,10,0,0,0
8476043,20,19,0,2,2
8475224,9,3,0,0,0
8475224,6,12,0,3,3
8475224,53,35,4,0,4
8479557,29,3,0,0,0
8475902,5,24,0,1,1
8475902,6,67,3,9,12
8480314,9,16,2,2,4
8478844,4,35,2,3,5
8475738,8,65,12,13,25
8475738,4,124,19,23,42
8475738,53,19,1,1,2
8475738,26,10,0,0,0
8481637,16,4,0,0,0
8474668,8,184,28,36,64
8474668,4,152,17,17,34
8474668,16,15,0,1,1
8474668,23,84,6,12,18
8468508,12,184,47,68,115
8468508,15,162,46,54,100
8468508,26,211,48,69,117
8474569,21,130,18,31,49
8474569,18,317,56,97,153
8476293,7,70,7,12,19
8476293,17,17,0,0,0
8476293,5,106,13,19,32
8481630,20,4,0,0,0
8481515,28,4,0,0,0
8477458,54,25,3,3,6
8477458,12,25,4,7,11
8477458,22,5,0,0,0
8477413,21,133,20,35,55
8477413,8,83,11,17,28
8475423,23,52,6,8,14
8475423,9,3,0,0,0
8473492,3,5,1,0,1
8473492,6,143,18,27,45
8473492,24,162,39,30,69
8473534,7,23,2,2,4
8473534,19,384,93,66,159
8476423,23,48,8,4,12
8476423,1,82,11,18,29
8476423,18,3,1,0,1
8475736,3,14,1,3,4
8475736,13,67,5,12,17
8480771,26,5,0,2,2
8470803,22,70,6,3,9
8470803,19,226,25,34,59
8470803,30,202,25,31,56
8476806,30,56,3,5,8
8476806,14,281,19,41,60
8476806,24,23,1,2,3
8475982,9,6,0,1,1
8475982,7,2,0,0,0
8471761,19,58,4,7,11
8471761,20,126,3,21,24
8470834,52,462,90,220,310
8471339,14,307,54,78,132
8471339,3,90,27,29,56
8478078,28,13,1,0,1
8477865,17,5,0,0,0
8476431,29,4,0,0,0
8476431,53,5,0,2,2
8476431,3,31,2,9,11
8476431,22,20,1,5,6
8476431,5,9,0,1,1
8476431,23,17,0,2,2
8476431,16,4,1,1,2
8473588,25,6,1,0,1
8473588,14,67,6,5,11
8473588,9,192,19,32,51
8471490,24,2,0,0,0
8471490,3,4,0,0,0
8471490,25,70,10,6,16
8471490,23,44,5,5,10
8471490,22,8,0,0,0
8471490,29,17,0,1,1
8471490,19,39,2,6,8
8464989,5,225,36,47,83
8464989,30,121,18,31,49
8464989,18,139,17,47,64
8474659,18,2,0,1,1
8474659,2,64,2,17,19
8477009,24,20,0,1,1
8477009,14,83,3,19,22
8471273,29,430,72,153,225
8470622,24,29,12,3,15
8470622,25,160,46,35,81
8470622,17,59,4,9,13
8470622,18,5,0,0,0
8475206,9,3,0,1,1
8475206,53,19,2,4,6
8475206,18,2,0,0,0
8475206,21,24,2,3,5
8473992,9,10,0,0,0
8473992,7,98,1,9,10
8473992,29,29,1,5,6
8473992,30,49,0,3,3
8473992,3,21,0,2,2
8470611,30,72,7,8,15
8470611,28,14,3,1,4
8470611,10,5,0,0,0
8470611,5,107,14,11,25
8470611,15,189,41,40,81
8478417,6,29,3,6,9
8479657,16,24,3,3,6
8479206,2,42,3,5,8
8479970,22,15,0,3,3
8474520,22,17,1,0,1
8474520,54,8,0,1,1
8474520,14,212,10,40,50
8474520,23,128,15,34,49
8479330,1,1,0,0,0
8472410,2,31,1,5,6
8472410,1,257,14,35,49
8471958,14,139,10,24,34
8471958,3,346,17,73,90
8479416,25,4,0,1,1
8477399,4,11,0,0,0
8473468,1,10,0,0,0
8473468,22,114,3,11,14
8473468,9,165,4,25,29
8478541,29,91,8,7,15
8471691,25,45,6,6,12
8471691,53,256,63,91,154
8471691,30,20,4,9,13
8468611,30,22,0,2,2
8468611,52,64,5,9,14
8468611,22,214,20,18,38
8468611,18,44,2,2,4
8468611,15,48,5,3,8
8477959,2,53,7,17,24
8477945,25,87,2,11,13
8471436,7,14,0,2,2
8471436,5,42,4,6,10
8471436,10,132,3,26,29
8471436,3,55,2,9,11
8471436,21,44,0,6,6
8476617,54,27,2,5,7
8480143,19,1,0,0,0
8480143,8,25,1,3,4
8480143,15,11,1,3,4
8474131,53,70,6,7,13
8470616,24,346,76,104,180
8470616,23,94,29,27,56
8480955,13,32,0,8,8
8480082,24,1,0,0,0
8480082,30,1,0,0,0
8475260,4,23,1,3,4
8475260,13,20,2,5,7
8475260,20,9,1,0,1
8479290,24,19,2,1,3
8468509,17,486,34,181,215
8475323,16,394,28,63,91
8475323,12,48,1,5,6
8481426,17,10,0,0,0
8470543,16,56,5,5,10
8470543,14,82,13,16,29
8470543,5,351,100,129,229
8479250,1,60,5,3,8
8474627,4,89,4,7,11
8474627,19,218,30,70,100
8475715,54,98,13,10,23
8475715,9,20,5,3,8
8475715,3,134,21,27,48
8473933,1,190,5,17,22
8473933,25,20,0,2,2
8473933,5,89,5,8,13
8473933,24,150,6,33,39
8473584,4,291,11,61,72
8473584,2,111,7,29,36
8468001,13,304,20,34,54
8468001,29,114,12,14,26
8477357,12,34,4,4,8
8478365,14,9,0,2,2
8478365,4,4,0,0,0
8478561,16,33,2,3,5
8478561,21,110,7,11,18
8478561,8,9,0,0,0
8477452,13,60,4,3,7
8473465,13,95,17,19,36
8473465,53,72,9,8,17
8473465,7,63,14,13,27
8473465,24,21,8,4,12
8473465,21,145,34,32,66
8471657,3,56,1,2,3
8471657,18,61,5,2,7
8471657,21,311,29,22,51
8471717,3,36,2,3,5
8471717,29,14,1,1,2
8471717,6,304,7,33,40
8475263,17,11,0,1,1
8475263,19,4,1,0,1
8470760,25,45,1,2,3
8470760,9,304,14,55,69
8476476,52,59,2,10,12
8476476,8,38,5,6,11
8476476,6,65,2,7,9
8476465,30,23,2,3,5
8476465,1,1,0,1,1
8476465,12,151,6,31,37
8479268,7,93,4,14,18
8480954,16,2,0,0,0
8478031,52,11,0,0,0
8475325,19,14,0,2,2
8475325,7,69,4,4,8
8475325,26,266,18,20,38
8468498,15,332,5,57,62
8468498,5,118,2,19,21
8480943,10,53,3,4,7
8475175,9,115,17,10,27
8475175,19,189,19,20,39
8475175,22,42,9,7,16
8474061,20,4,0,0,0
8474061,15,2,0,0,0
8474061,52,142,4,10,14
8475755,13,254,5,44,49
8475755,22,9,0,1,1
8470602,26,93,4,12,16
8470602,9,154,13,41,54
8470602,10,249,23,89,112
8476370,1,38,1,3,4
8469521,8,433,91,152,243
8469521,10,17,0,2,2
8469506,7,192,42,48,90
8469506,30,327,76,130,206
8476477,17,8,1,0,1
8476477,3,27,6,3,9
8476477,9,52,4,2,6
8471768,9,200,16,31,47
8471768,14,70,11,12,23
8476427,22,64,9,11,20
8476427,12,5,0,2,2
8476427,19,30,4,4,8
8476177,30,12,1,0,1
8476177,4,358,63,77,140
8478268,9,10,0,0,0
8476971,24,28,6,1,7
8477510,20,2,0,0,0
8477510,8,4,1,1,2
8477510,29,37,2,10,12
8477957,26,8,1,0,1
8477957,8,29,5,2,7
8476799,52,4,0,1,1
8476799,15,6,0,0,0
8473673,8,55,1,6,7
8473673,28,62,2,16,18
8473673,1,67,6,13,19
8473673,53,98,3,16,19
8473673,20,19,0,0,0
8473673,25,5,0,0,0
8476877,19,42,0,5,5
8481486,54,1,0,1,1
8476310,29,162,15,12,27
8475758,15,129,11,13,24
8475758,1,71,12,10,22
8475758,8,66,7,8,15
8475758,24,80,7,20,27
8478373,19,17,1,1,2
8478373,10,70,7,7,14
8475727,22,25,2,1,3
8475727,3,36,5,13,18
8475727,23,11,0,4,4
8475727,6,253,41,101,142
8471226,1,116,13,15,28
8471226,52,144,34,36,70
8471226,6,18,4,4,8
8471226,7,166,31,45,76
8470740,6,21,3,7,10
8470740,12,119,19,30,49
8470740,1,63,16,25,41
8470740,3,53,9,9,18
8470740,52,18,6,4,10
8470740,20,99,17,38,55
8470740,5,21,4,7,11
8480161,17,6,0,0,0
8474025,1,6,0,1,1
8474025,17,1,0,0,0
8474025,8,7,0,0,0
8474025,52,91,4,6,10
8474025,5,5,0,0,0
8481425,23,1,0,0,0
8469501,19,51,1,6,7
8469501,52,324,20,25,45
8477994,17,9,0,0,0
8470598,17,112,31,43,74
8470598,23,61,17,24,41
8470598,29,19,7,8,15
8470598,13,20,2,8,10
8470598,30,154,39,54,93
8470598,2,47,17,27,44
8470598,8,18,6,9,15
8470598,7,51,24,26,50
8475321,4,47,3,4,7
8475321,9,8,0,1,1
8475321,7,42,5,4,9
8475253,5,50,2,6,8
8475253,13,34,0,0,0
8480948,1,25,2,5,7
8479755,7,47,0,10,10
8477428,26,2,0,0,0
8479483,22,33,3,6,9
8479483,1,25,2,2,4
8476322,13,8,0,0,0
8477491,7,47,7,3,10
8467400,24,249,24,57,81
8467400,21,163,13,39,52
8475761,19,6,0,0,0
8475761,1,65,8,11,19
8475761,5,129,16,29,45
8470609,2,28,1,5,6
8470609,1,192,27,32,59
8477006,30,9,0,1,1
8469598,24,211,7,30,37
8469598,23,172,14,36,50
8477453,21,46,1,3,4
8471663,9,3,0,0,0
8471663,14,22,3,2,5
8471663,8,12,0,0,0
8471766,24,61,1,3,4
8471766,29,173,5,11,16
8471266,17,28,4,1,5
8471266,10,59,7,6,13
8471266,23,78,10,12,22
8474642,16,53,3,6,9
8474642,20,261,26,37,63
8475739,14,24,2,1,3
8475739,8,89,10,9,19
8476283,29,2,0,0,0
8475788,23,24,2,4,6
8475788,53,26,5,9,14
8475788,52,148,11,22,33
8470358,9,91,12,13,25
8470358,23,300,54,60,114
8469500,22,51,4,18,22
8469500,26,15,3,4,7
8469500,1,171,51,60,111
8469500,20,107,39,38,77
8476401,3,1,0,0,0
8476401,7,11,0,0,0
8466251,2,140,22,22,44
8466251,24,16,1,1,2
8466251,15,288,45,70,115
8471710,15,97,3,12,15
8471710,29,1,0,0,0
8471710,5,7,0,0,0
8476302,5,7,0,0,0
8476302,10,41,1,5,6
8476302,23,28,2,0,2
8476020,26,2,0,0,0
8476403,12,76,3,8,11
8476403,53,90,2,9,11
8476403,16,4,1,0,1
8471976,3,71,6,22,28
8471976,8,305,55,112,167
8471976,22,18,2,2,4
8474018,9,27,6,4,10
8473432,23,184,20,34,54
8473432,3,51,4,4,8
8473432,29,24,3,6,9
8480153,16,6,0,1,1
8471296,18,76,1,8,9
8471296,8,313,11,54,65
8470828,52,339,22,82,104
8475157,30,2,1,0,1
8475157,6,58,5,5,10
8475157,17,17,1,0,1
8479613,24,1,0,0,0
8467370,18,330,82,96,178
8480330,20,4,2,0,2
8471742,16,23,1,6,7
8471742,7,127,7,29,36
8471742,10,179,15,79,94
8471742,18,23,1,3,4
8468483,26,228,61,59,120
8468483,9,16,4,3,7
8468483,29,34,9,13,22
8468483,3,35,9,10,19
8478063,15,3,0,1,1
8467407,6,20,2,5,7
8467407,7,230,40,63,103
8467407,8,129,32,34,66
8470854,20,16,0,0,0
8470854,3,134,6,9,15
8470854,5,115,5,10,15
8470324,7,223,3,23,26
8470324,8,114,3,20,23
8480164,13,5,0,1,1
8475878,53,8,0,0,0
8475878,20,38,3,2,5
8475878,21,17,1,0,1
8475878,28,12,0,0,0
8471498,28,61,4,17,21
8471498,23,294,65,66,131
8468486,18,62,13,11,24
8468486,29,234,64,82,146
8468486,4,110,28,35,63
8474625,1,33,3,6,9
8474625,6,133,15,19,34
8474625,13,125,30,23,53
8474625,16,12,1,3,4
8469466,8,7,0,0,0
8469466,25,166,28,50,78
8469466,22,93,18,28,46
8469466,9,20,4,13,17
8479595,16,4,1,0,1
8475180,3,23,1,3,4
8475180,53,40,5,6,11
8475180,10,174,25,38,63
8475180,24,25,4,2,6
8480163,23,1,0,0,0
8475949,20,3,0,0,0
8475949,3,21,0,3,3
8448208,20,22,1,6,7
8448208,13,181,49,81,130
8448208,1,139,35,61,96
8448208,25,34,14,12,26
8448208,6,11,2,7,9
8469638,26,18,1,4,5
8469638,29,14,0,1,1
8469638,22,14,0,1,1
8469638,23,14,4,6,10
8469638,13,231,37,95,132
8469638,5,91,28,40,68
8469638,12,33,6,5,11
8477591,12,31,3,3,6
8477591,5,9,0,0,0
8477591,53,42,3,7,10
8477591,3,12,1,1,2
8477591,20,119,16,21,37
8475185,7,39,2,2,4
8475185,1,207,13,28,41
8467967,24,12,0,2,2
8467967,9,82,5,7,12
8467967,6,182,21,36,57
8476866,24,3,0,0,0
8477449,20,1,0,0,0
8473579,2,248,37,42,79
8473579,10,118,16,27,43
8469639,26,12,0,1,1
8469639,15,186,17,29,46
8469639,10,21,1,6,7
8476955,4,55,2,5,7
8478004,8,21,0,1,1
8475436,24,7,0,1,1
8475436,18,1,0,0,0
8476397,22,2,0,0,0
8476397,12,2,0,0,0
8468542,28,173,7,41,48
8468542,5,147,12,46,58
8473574,52,72,9,6,15
8473574,10,51,6,11,17
8473574,21,20,6,5,11
8473574,23,96,21,13,34
8473574,13,107,23,14,37
8475310,25,99,10,13,23
8477981,12,10,0,3,3
8478842,21,10,1,2,3
8471338,26,49,6,5,11
8471338,8,174,19,18,37
8471338,7,60,7,7,14
8471338,30,103,5,12,17
8476619,30,34,3,2,5
8468575,10,50,6,6,12
8468575,6,82,11,14,25
8468575,3,235,22,38,60
8470852,7,297,46,77,123
8470852,30,20,6,7,13
8470852,2,58,21,32,53
8477634,53,8,1,2,3
8470041,3,375,145,107,252
8470041,6,11,3,3,6
8474024,9,39,5,2,7
8474024,1,4,0,0,0
8476303,3,22,0,3,3
8476303,6,11,0,0,0
8473440,4,1,0,0,0
8471811,30,1,0,0,0
8471811,7,31,3,5,8
8469665,9,51,4,4,8
8469665,4,1,0,0,0
8469665,25,119,5,23,28
8469665,16,216,9,31,40
8476336,22,134,10,13,23
8474074,6,14,0,1,1
8474074,52,187,10,24,34
8471678,7,74,13,6,19
8471678,22,180,41,43,84
8471678,3,80,15,21,36
8471678,14,34,8,12,20
8476386,2,84,9,16,25
8476386,9,44,3,10,13
8470724,30,18,0,3,3
8470724,1,53,4,8,12
8470724,29,20,2,1,3
8470724,17,238,12,33,45
8477929,24,27,1,3,4
8477929,16,112,8,9,17
8474743,7,3,0,0,0
8474743,8,16,0,5,5
8474743,21,96,7,19,26
8474743,52,18,2,5,7
8480761,19,1,0,0,0
8475147,29,21,1,1,2
8475147,30,88,11,14,25
8475147,23,56,6,9,15
8467875,23,447,114,209,323
8467876,23,438,69,254,323
8469619,2,101,5,22,27
8469619,6,223,9,44,53
8475328,9,2,0,0,0
8469544,16,248,66,96,162
8469544,25,124,28,45,73
8479650,54,3,1,0,1
8476890,9,1,1,0,1
8476890,20,1,1,0,1
8476464,21,20,1,1,2
8477415,22,102,10,13,23
8476450,3,16,1,4,5
8476450,17,28,1,6,7
8470162,20,394,42,83,125
8468309,8,2,0,0,0
8468309,4,274,30,110,140
8468309,5,19,1,5,6
8468309,2,48,6,21,27
8470105,19,206,23,28,51
8470105,13,166,27,30,57
8477642,8,2,0,0,0
8477642,10,10,0,0,0
8477583,13,1,0,0,0
8468535,24,136,17,27,44
8468535,53,269,67,72,139
8468535,16,19,0,3,3
8471346,20,93,18,27,45
8471346,12,63,11,22,33
8471346,26,14,4,1,5
8471346,16,124,24,39,63
8471346,13,28,4,7,11
8468085,13,42,5,9,14
8468085,53,195,52,82,134
8468085,23,142,44,46,90
8468208,28,209,36,48,84
8468208,15,203,51,52,103
8474660,21,16,0,5,5
8474660,5,19,1,1,2
8474660,1,10,0,1,1
8474660,6,10,1,2,3
8474739,16,57,7,5,12
8474739,6,18,2,3,5
8474739,28,299,48,65,113
8474739,9,36,2,2,4
8471476,30,81,6,17,23
8471476,15,92,14,16,30
8471476,10,114,11,28,39
8471476,5,21,2,7,9
8471476,24,124,12,37,49
8476855,21,58,9,7,16
8476855,19,40,3,6,9
8476855,22,252,50,61,111
8468083,17,414,85,251,336
8476805,16,1,0,0,0
8476805,10,1,0,0,0
8477041,7,5,0,0,0
8478376,9,7,0,0,0
8478376,10,6,1,0,1
8471760,18,26,0,0,0
8471760,29,1,0,0,0
8475192,22,3,0,0,0
8475192,3,2,0,0,0
8475192,2,2,0,0,0
8475192,18,85,11,12,23
8471254,12,11,1,0,1
8471254,16,212,34,34,68
8471504,21,65,12,6,18
8471504,29,57,7,5,12
8471504,24,30,2,6,8
8471504,8,103,16,15,31
8475296,17,5,0,0,0
8466285,16,80,5,12,17
8466285,13,294,24,98,122
8476219,30,3,0,0,0
8470640,18,6,0,1,1
8470640,14,253,13,67,80
8474577,21,62,4,4,8
8474577,20,217,37,63,100
8474577,10,5,0,0,0
8471956,16,136,8,8,16
8471956,28,179,10,18,28
8475155,24,49,1,9,10
8475155,5,126,4,25,29
8462038,53,342,84,100,184
8475770,24,115,15,16,31
8475770,23,39,7,5,12
8475770,3,19,0,3,3
8476769,8,3,0,0,0
8476769,1,50,8,2,10
8476769,5,14,0,0,0
8471816,22,147,4,13,17
8471816,1,103,5,12,17
8469759,1,39,1,2,3
8469759,18,20,1,0,1
8469759,25,284,35,56,91
8476808,8,116,10,10,20
8476808,7,159,17,24,41
8476116,24,64,7,4,11
8476116,16,43,2,4,6
8476116,25,178,28,39,67
8477715,53,20,1,3,4
8473989,1,11,0,0,0
8473989,22,136,5,3,8
8475199,21,33,0,1,1
8475199,1,156,14,40,54
8470104,26,18,1,4,5
8470104,8,117,5,9,14
8470104,13,73,3,25,28
8470104,30,43,3,10,13
8470159,4,13,1,0,1
8470159,53,113,6,12,18
8470159,22,142,14,20,34
8475774,18,37,0,2,2
8475774,10,8,0,0,0
8470121,26,154,6,12,18
8476414,23,9,0,0,0
8471269,20,3,0,0,0
8471269,53,58,3,4,7
8471269,4,176,7,25,32
8475597,13,14,2,1,3
8475274,1,50,1,3,4
8476511,21,1,1,0,1
8466148,16,331,108,122,230
8475769,52,5,0,0,0
8475769,13,92,10,7,17
8470201,25,32,3,8,11
8470201,20,248,68,124,192
8470201,13,19,6,5,11
8462042,21,225,59,65,124
8462042,26,19,6,3,9
8462042,6,78,30,31,61
8462042,20,31,9,13,22
8462042,5,13,5,6,11
8476482,3,7,0,0,0
8476482,23,24,3,3,6
8478963,8,10,0,0,0
8476279,20,56,1,11,12
8476279,9,3,0,0,0
8476279,25,91,2,14,16
8477881,2,4,0,0,0
8478566,1,121,10,9,19
8480081,1,5,0,0,0
8471996,2,4,0,1,1
8471996,28,26,3,2,5
8471693,13,58,0,6,6
8471693,17,167,13,38,51
8474100,26,315,47,47,94
8474100,8,17,1,0,1
8470630,3,224,22,50,72
8470630,18,94,4,13,17
8471232,25,60,8,12,20
8471232,29,9,0,0,0
8471232,22,71,10,12,22
8471232,53,169,21,36,57
8476425,23,13,0,0,0
8475165,22,159,8,21,29
8474707,23,26,1,5,6
8474707,22,30,3,9,12
8474707,25,32,2,3,5
8468639,6,53,0,11,11
8468639,12,156,10,36,46
8468639,10,38,2,9,11
8478371,17,2,0,1,1
8479648,4,47,4,2,6
8470667,9,149,40,51,91
8470667,10,40,8,12,20
8476289,17,110,3,16,19
8476289,10,11,1,1,2
8467496,8,354,38,165,203
8473571,53,3,0,0,0
8473571,26,70,5,13,18
8473571,7,69,6,11,17
8473571,12,40,1,7,8
8469508,12,224,15,25,40
8469508,10,129,12,15,27
8470644,4,8,2,0,2
8470644,2,133,17,26,43
8477091,23,1,0,0,0
8476471,25,1,0,0,0
8476471,16,1,0,0,0
8475815,52,30,0,2,2
8470599,10,18,2,6,8
8470599,9,203,40,57,97
8469760,53,219,6,21,27
8469760,19,15,2,2,4
8470778,17,291,22,23,45
8475291,15,1,0,0,0
8470750,21,326,45,61,106
8479969,23,5,0,0,0
8478562,12,3,0,0,0
8478562,20,27,2,3,5
8467493,9,295,22,28,50
8475250,12,115,17,29,46
8475250,17,13,0,2,2
8476162,5,11,0,1,1
8476162,15,62,3,16,19
8468505,17,42,3,3,6
8468505,8,11,0,1,1
8468505,19,122,3,14,17
8468505,7,107,18,26,44
8471385,18,4,0,0,0
8471385,52,129,0,16,16
8471385,22,9,0,3,3
8471385,7,17,0,4,4
8469707,1,59,13,14,27
8469707,18,8,0,1,1
8469707,10,77,20,21,41
8469707,8,56,8,14,22
8469707,21,103,32,44,76
8471331,5,43,0,3,3
8471331,7,43,4,6,10
8475800,30,9,1,0,1
8475800,53,4,1,0,1
8475800,17,70,11,9,20
8473962,26,12,0,2,2
8473962,22,143,23,43,66
8473962,13,15,3,8,11
8473962,14,129,23,55,78
8471664,24,4,0,0,0
8471664,20,86,16,12,28
8471664,10,82,19,26,45
8471664,23,46,10,12,22
8477916,23,1,0,0,0
8477916,21,14,1,1,2
8467371,18,209,26,111,137
8467371,53,80,16,31,47
8467371,15,48,13,36,49
8476911,14,3,0,0,0
8475210,23,3,0,1,1
8465058,16,207,4,45,49
8476418,17,19,0,0,0
8476766,7,6,0,1,1
8468513,4,189,3,26,29
8468513,22,108,1,12,13
8468513,29,9,0,1,1
8473542,5,17,0,3,3
8473542,23,103,6,5,11
8473542,4,7,2,0,2
8471682,26,45,4,8,12
8471682,20,12,0,0,0
8471682,52,75,11,16,27
8471682,30,48,13,14,27
8477445,20,14,2,2,4
8477445,23,1,0,0,0
8476416,22,3,0,0,0
8471681,23,55,5,4,9
8471681,21,74,8,6,14
8471681,29,61,10,2,12
8471681,13,40,3,9,12
8474727,10,52,4,6,10
8474727,21,4,0,0,0
8474727,28,25,2,3,5
8474727,16,137,20,16,36
8473942,18,1,0,0,0
8473942,10,82,6,8,14
8473942,5,1,0,0,0
8477466,24,5,0,1,1
8473537,12,57,9,3,12
8473537,9,18,2,2,4
8473537,3,75,9,11,20
8473537,18,95,10,18,28
8473537,16,47,9,14,23
8476798,1,11,0,3,3
8476798,21,7,0,0,0
8476798,28,5,0,0,0
8470886,24,133,3,14,17
8470886,30,111,1,14,15
8473565,52,5,0,2,2
8473565,2,170,6,20,26
8470614,52,287,9,29,38
8474052,8,14,2,2,4
8474052,12,138,20,14,34
8476200,13,21,0,3,3
8476200,1,3,0,0,0
8476526,1,3,0,0,0
8465978,13,146,4,10,14
8465978,6,109,8,7,15
8477566,12,4,0,2,2
8469547,16,50,2,1,3
8469547,1,134,14,10,24
8469547,17,53,3,6,9
8474130,24,1,0,0,0
8474130,29,105,3,15,18
8474130,7,9,0,1,1
8477997,23,79,3,8,11
8469492,21,69,1,12,13
8469492,29,245,12,54,66
8471762,4,250,17,28,45
8471762,22,11,0,0,0
8477326,14,24,0,4,4
8475223,20,4,0,0,0
8475223,23,116,14,25,39
8475223,26,18,0,5,5
8473466,53,46,7,6,13
8473466,30,19,2,1,3
8473466,4,107,17,11,28
8473466,8,78,3,4,7
8469770,20,280,32,104,136
8474605,21,57,4,8,12
8474605,9,203,12,48,60
8476452,20,30,0,5,5
8477816,23,6,0,2,2
8476158,18,24,2,2,4
8476158,24,1,0,0,0
8476158,2,2,0,0,0
8476158,5,13,2,0,2
8476158,4,7,0,1,1
8474168,17,200,15,21,36
8471916,14,8,1,0,1
8476062,10,20,3,1,4
8476062,22,78,11,19,30
8476062,53,27,9,7,16
8476062,5,10,0,2,2
8476062,18,4,1,0,1
8473658,8,9,0,0,0
8473658,18,112,1,22,23
8478393,16,5,0,0,0
8470378,19,2,0,0,0
8470378,7,59,1,8,9
8470378,21,79,7,21,28
8470378,9,33,3,7,10
8473550,21,21,0,2,2
8473550,29,16,0,2,2
8471245,13,78,7,21,28
8471245,10,23,8,4,12
8471245,16,35,7,7,14
8475650,20,116,3,6,9
8475650,16,107,7,7,14
8460720,2,54,4,2,6
8468504,10,60,8,16,24
8468504,13,156,35,39,74
8468504,2,48,10,25,35
8467096,3,139,19,25,44
8467096,28,121,19,37,56
8474113,10,13,1,1,2
8474113,13,19,2,7,9
8474113,7,10,1,0,1
8475161,15,12,2,1,3
8475161,53,11,0,0,0
8471371,28,104,3,5,8
8471371,8,14,1,1,2
8471371,22,35,1,0,1
8471371,10,12,0,1,1
8475757,30,8,0,0,0
8474638,10,6,0,1,1
8474638,53,33,0,1,1
8474638,26,3,0,0,0
8470169,29,82,3,8,11
8470169,6,200,18,28,46
8475150,19,4,0,0,0
8475150,21,19,0,0,0
8475150,6,63,2,4,6
8473646,30,113,10,15,25
8473646,1,106,13,12,25
8471231,53,266,18,42,60
8470920,29,26,2,2,4
8470920,10,118,15,11,26
8470920,1,48,15,9,24
8471733,10,19,0,4,4
8471733,18,106,7,9,16
8469470,7,36,1,4,5
8469470,4,33,2,6,8
8469470,19,25,1,3,4
8469470,17,6,0,1,1
8474744,15,2,0,0,0
8474744,29,19,0,3,3
8474616,52,22,0,3,3
8475174,9,166,10,19,29
8474019,6,3,0,1,1
8475414,53,29,1,4,5
8475414,6,34,2,1,3
8467514,17,221,74,126,200
8476379,8,13,1,4,5
8471703,53,26,3,3,6
8471703,5,72,14,14,28
8471703,4,51,3,14,17
8471703,21,13,1,7,8
8466393,5,121,35,38,73
8475661,9,26,3,3,6
8469555,26,40,2,8,10
8469555,16,8,0,2,2
8469555,5,49,3,11,14
8469555,7,126,11,44,55
8460542,1,198,47,84,131
8475782,8,3,0,0,0
8476505,20,1,0,1,1
8477902,21,70,3,9,12
8466333,22,147,6,26,32
8466333,6,48,4,9,13
8470039,8,57,10,10,20
8470039,16,19,4,1,5
8470039,13,180,27,57,84
8470039,24,14,1,5,6
8476235,30,197,27,41,68
8471309,17,130,37,58,95
8476384,24,6,0,0,0
8475836,23,1,0,0,0
8475816,15,26,1,3,4
8468700,18,234,18,28,46
8467351,19,21,1,7,8
8467351,9,13,0,1,1
8467351,1,58,7,27,34
8467351,13,46,2,10,12
8467351,28,39,2,13,15
8475759,21,26,0,1,1
8475759,53,32,2,2,4
8471362,2,109,18,26,44
8471362,15,58,13,22,35
8471362,10,48,9,7,16
8471752,1,4,0,0,0
8471752,12,1,0,0,0
8474005,53,5,0,0,0
8474005,24,2,2,0,2
8471862,10,30,7,8,15
8471862,9,150,15,22,37
8470317,21,173,3,21,24
8474094,52,123,8,13,21
8474094,18,36,5,6,11
8467899,19,2,1,0,1
8467899,1,40,5,9,14
8467899,28,88,20,20,40
8470274,23,229,42,52,94
8474570,18,39,3,5,8
8474570,7,198,41,50,91
8473431,8,1,0,0,0
8467423,24,59,6,9,15
8467423,25,153,18,31,49
8467423,22,31,7,5,12
8467890,18,73,1,4,5
8467890,19,205,8,34,42
8469490,24,83,8,3,11
8469490,20,52,2,4,6
8474138,53,7,1,1,2
8474138,25,24,2,1,3
8474138,5,34,3,4,7
8470877,20,174,32,30,62
8470877,30,16,2,1,3
8470877,21,33,3,6,9
8474661,12,79,3,4,7
8478564,6,44,2,3,5
8477589,23,38,4,8,12
8471311,1,50,3,13,16
8471311,28,92,8,18,26
8471311,2,13,2,3,5
8471311,5,46,6,5,11
8477923,30,1,0,0,0
8476435,6,9,0,0,0
8473970,22,54,2,2,4
8473970,53,113,19,15,34
8473970,5,10,1,2,3
8476910,52,8,0,3,3
8474497,9,15,0,1,1
8474497,3,7,0,1,1
8474497,14,19,2,6,8
8474497,16,9,2,1,3
8474497,10,35,0,8,8
8475247,15,113,4,13,17
8467329,26,42,10,7,17
8467329,4,133,28,30,58
8467329,14,39,10,22,32
8467330,7,79,5,9,14
8467330,9,80,9,18,27
8467330,18,110,22,43,65
8467330,17,21,4,7,11
8474516,28,8,1,0,1
8476451,8,12,1,1,2
8476451,53,29,2,3,5
8477427,10,6,0,2,2
8477076,52,9,0,1,1
8477033,10,4,0,2,2
8470207,10,186,54,43,97
8474850,16,41,4,1,5
8474850,3,10,0,0,0
8473562,28,37,1,1,2
8475756,13,3,0,0,0
8475775,14,2,0,0,0
8475775,28,33,1,4,5
8475775,53,18,1,1,2
8475775,4,36,7,3,10
8478563,4,45,4,8,12
8476352,26,17,1,2,3
8477249,22,15,1,5,6
8465185,13,112,4,11,15
8465185,26,76,1,11,12
8468635,25,57,3,8,11
8468635,8,120,4,14,18
8476147,5,1,0,0,0
8476147,2,6,1,1,2
8478584,1,7,0,0,0
8471348,22,53,4,7,11
8471348,29,104,5,19,24
8470180,18,185,29,11,40
8470180,25,48,7,4,11
8476772,1,22,0,2,2
8475153,13,96,5,16,21
8470230,3,12,0,0,0
8470230,6,189,25,23,48
8476394,29,1,0,0,0
8476394,16,1,0,1,1
8476388,23,13,0,0,0
8476478,10,12,0,3,3
8478928,5,32,0,2,2
8478928,53,13,0,1,1
8477486,20,8,0,1,1
8470871,30,61,4,3,7
8470871,19,75,3,8,11
8470714,18,1,0,0,0
8470714,20,6,0,0,0
8470714,22,49,3,6,9
8470714,6,3,0,0,0
8471283,23,35,1,6,7
8471283,8,172,15,30,45
8475829,29,1,0,0,0
8475829,20,1,0,0,0
8475292,6,27,6,0,6
8474698,13,7,0,0,0
8476852,22,29,0,1,1
8476852,2,8,0,1,1
8467389,17,68,10,18,28
8467389,16,76,12,25,37
8467389,3,128,31,54,85
8470617,15,39,2,3,5
8470617,26,183,28,61,89
8475182,16,63,3,13,16
8475182,53,20,0,2,2
8469462,1,129,10,12,22
8469462,12,74,9,16,25
8475194,53,8,0,0,0
8475194,5,5,0,0,0
8471390,24,70,9,9,18
8471390,10,57,11,18,29
8471390,18,22,1,3,4
8471390,23,49,10,18,28
8471390,13,24,2,1,3
8471390,52,10,0,1,1
8471240,26,10,0,1,1
8471240,15,26,0,3,3
8473722,53,11,0,1,1
8473722,8,1,0,0,0
8473722,28,38,3,1,4
8473722,7,90,1,0,1
8467452,5,160,1,17,18
8467452,26,69,1,17,18
8467452,16,17,0,0,0
8478137,24,41,3,7,10
8478137,53,11,0,2,2
8478137,16,6,0,1,1
8478137,8,50,7,9,16
8474554,53,1,0,0,0
8474554,13,2,0,1,1
8470120,8,15,1,3,4
8470120,12,166,41,64,105
8475119,15,10,1,0,1
8475119,5,62,1,2,3
8475119,10,21,0,1,1
8476209,1,42,3,2,5
8471222,20,109,1,6,7
8471222,22,65,2,4,6
8474096,10,35,1,6,7
8474096,28,23,2,4,6
8474096,5,82,9,18,27
8474096,18,118,22,23,45
8475598,15,1,0,0,0
8475598,23,118,4,23,27
8475598,16,1,0,0,0
8468526,30,51,3,3,6
8468526,3,29,1,2,3
8468526,26,199,21,41,62
8470729,30,2,0,0,0
8470729,7,46,0,5,5
8470729,15,18,0,2,2
8470729,13,38,0,4,4
8467331,21,71,3,10,13
8467331,28,109,3,14,17
8473589,3,6,0,0,0
8473589,53,41,2,4,6
8475980,12,12,0,0,0
8477300,16,27,2,2,4
8470171,6,56,2,8,10
8470171,21,133,12,28,40
8470171,4,46,6,6,12
8467338,21,148,30,58,88
8467338,53,18,4,9,13
8467338,20,40,11,16,27
8475060,14,12,0,0,0
8475749,8,25,1,2,3
8475749,53,1,0,0,0
8475749,3,1,0,0,0
8474588,53,39,3,3,6
8474588,16,11,0,0,0
8473482,1,30,2,2,4
8473482,12,168,52,39,91
8473482,52,20,1,7,8
8469469,4,106,11,15,26
8469469,29,122,26,26,52
8471856,53,71,3,6,9
8471856,5,86,3,16,19
8473426,7,209,4,24,28
8473426,15,10,0,0,0
8476819,19,2,0,0,0
8476819,23,19,1,0,1
8476819,12,5,0,1,1
8470222,12,1,0,0,0
8470222,29,161,20,74,94
8470222,24,13,0,5,5
8476944,12,7,0,0,0
8469623,2,53,4,12,16
8469623,1,192,20,64,84
8469623,17,21,3,8,11
8464977,28,50,3,4,7
8464977,1,178,19,26,45
8476179,22,33,3,2,5
8474609,29,3,0,0,0
8474609,7,16,2,0,2
8465166,5,200,9,18,27
8475917,4,15,1,1,2
8467332,24,115,0,17,17
8467332,8,5,0,1,1
8477214,3,7,0,0,0
8475154,10,39,0,3,3
8474048,22,31,0,1,1
8474048,14,60,2,6,8
8470054,30,59,2,8,10
8470054,23,36,0,2,2
8474135,12,121,4,16,20
8470176,13,101,24,23,47
8470176,30,17,1,0,1
8474772,30,9,0,1,1
8474772,3,16,0,0,0
8475732,12,10,0,2,2
8475203,24,1,0,0,0
8474164,30,19,0,2,2
8474164,18,35,1,6,7
8470867,10,52,3,7,10
8470719,53,17,0,0,0
8471326,21,129,8,8,16
8475243,3,1,0,0,0
8474137,8,3,0,0,0
8474137,12,107,7,10,17
8474576,12,43,4,6,10
8474576,5,7,0,0,0
8474576,18,5,1,1,2
8466142,10,18,2,3,5
8466142,14,142,8,25,33
8466142,24,9,1,1,2
8464975,21,57,8,4,12
8464975,8,69,13,12,25
8464975,4,34,6,10,16
8475567,52,1,0,0,0
8475567,15,10,1,1,2
8477059,1,77,13,19,32
8477059,17,44,12,14,26
8470063,28,81,2,4,6
8470666,16,62,6,5,11
8470666,3,31,3,0,3
8470666,26,26,1,1,2
8475162,24,7,0,1,1
8466149,17,117,14,11,25
8471718,21,150,3,11,14
8471482,52,100,6,26,32
8469622,1,56,8,22,30
8469622,28,28,0,11,11
8469622,3,12,3,5,8
8467396,25,160,40,29,69
8467396,17,11,3,3,6
8467396,8,19,3,3,6
8472368,15,2,0,0,0
8472368,5,19,4,1,5
8472368,53,12,1,1,2
8465951,30,111,14,24,38
8465951,5,48,8,13,21
8470065,29,8,0,0,0
8470647,53,58,3,3,6
8470647,14,99,4,14,18
8471879,16,7,0,0,0
8475309,7,9,0,0,0
8475309,10,22,1,2,3
8476214,23,2,0,0,0
8476244,20,56,2,2,4
8476244,8,69,1,24,25
8476244,3,11,1,1,2
8476244,23,6,1,1,2
8470302,12,192,21,29,50
8473682,5,33,1,6,7
8473682,23,28,1,5,6
8474184,52,52,2,5,7
8474184,26,35,0,3,3
8474184,13,9,0,0,0
8470018,7,95,5,3,8
8468064,53,96,11,26,37
8468064,15,62,2,25,27
8468064,18,36,4,17,21
8475148,29,52,1,10,11
8475148,10,15,1,0,1
8475148,16,8,0,0,0
8476363,6,7,0,1,1
8471241,24,43,1,4,5
8471241,22,25,0,6,6
8470662,19,1,0,0,0
8470662,26,67,2,7,9
8471748,1,34,0,4,4
8471748,22,23,1,0,1
8471748,10,64,0,9,9
8475671,22,36,5,4,9
8475671,6,38,5,0,5
8475671,25,12,1,2,3
8474192,10,34,7,6,13
8474192,26,40,2,4,6
8474192,29,4,0,1,1
8467346,6,23,3,1,4
8467346,4,27,5,6,11
8467346,26,11,0,5,5
8474001,52,38,1,0,1
8474001,20,62,4,13,17
8474001,28,36,5,9,14
8469476,12,114,1,16,17
8469476,15,17,0,2,2
8469476,10,39,1,4,5
8471185,20,131,36,42,78
8471185,15,18,4,3,7
8469473,5,55,2,6,8
8469473,19,31,1,2,3
8469473,13,104,20,22,42
8458951,8,45,1,12,13
8458951,25,79,2,21,23
8458951,9,45,3,24,27
8475734,22,1,0,0,0
8472424,22,18,1,1,2
8472424,10,10,0,2,2
8466158,28,118,5,14,19
8466158,18,29,0,1,1
8469531,52,35,2,3,5
8469531,12,135,8,21,29
8472394,1,99,5,9,14
8477227,28,19,1,0,1
8468482,24,6,0,0,0
8468482,30,112,23,26,49
8470699,21,205,8,32,40
8474519,15,71,3,12,15
8474519,12,3,0,0,0
8475767,21,13,1,1,2
8474793,53,5,1,0,1
8477127,1,1,0,0,0
8473514,22,62,5,4,9
8473514,2,7,0,2,2
8466140,18,48,3,3,6
8466140,19,8,1,2,3
8466140,10,6,0,1,1
8466140,52,127,25,32,57
8471767,4,4,0,0,0
8471767,20,29,2,1,3
8471388,7,81,1,3,4
8475159,52,5,1,0,1
8468518,13,160,21,26,47
8475295,10,20,2,2,4
8470654,19,116,11,13,24
8470654,5,35,0,2,2
8470654,23,48,4,6,10
8475342,4,16,2,1,3
8467917,29,18,1,2,3
8467917,30,18,0,1,1
8467917,19,49,1,7,8
8467917,7,24,2,6,8
8477228,6,4,0,0,0
8470152,19,34,3,3,6
8470152,10,19,1,3,4
8474748,10,12,0,2,2
8467334,8,58,1,3,4
8467334,12,69,7,6,13
8467334,23,9,0,0,0
8467988,3,6,0,0,0
8467988,14,81,11,12,23
8469591,7,70,2,7,9
8469591,30,14,1,1,2
8467977,20,103,7,4,11
8467977,18,2,0,0,0
8474646,53,72,3,6,9
8474646,23,8,0,1,1
8474646,24,6,0,1,1
8471236,7,60,7,7,14
8471236,4,49,5,14,19
8471236,6,14,2,3,5
8475214,29,28,2,4,6
8475214,16,42,6,7,13
8471474,25,10,0,1,1
8466160,14,70,3,5,8
8466160,19,71,13,12,25
8466160,25,29,6,5,11
8466160,5,15,6,8,14
8469664,53,184,17,37,54
8474535,3,7,1,1,2
8474535,25,9,0,0,0
8474535,18,18,2,3,5
8476426,22,4,0,2,2
8470839,13,9,0,1,1
8470839,20,45,0,3,3
8470839,21,28,0,4,4
8474603,52,41,3,5,8
8468778,10,99,1,3,4
8464956,9,154,6,26,32
8473911,22,24,2,4,6
8473911,23,12,0,0,0
8473921,18,3,0,0,0
8475896,25,1,0,0,0
8470798,53,1,0,0,0
8470798,5,3,0,0,0
8467344,26,158,6,23,29
8467344,7,29,0,2,2
8471299,16,21,2,3,5
8471299,2,44,2,5,7
8471299,9,27,0,3,3
8475733,20,23,1,4,5
8475294,12,6,0,0,0
8474606,13,39,0,3,3
8474606,24,5,0,1,1
8462196,10,52,1,6,7
8462196,25,72,5,13,18
8462196,24,14,1,4,5
8472365,6,3,0,0,0
8469485,22,46,11,11,22
8469485,18,26,1,9,10
8469485,19,75,9,28,37
8469485,25,30,4,18,22
8469485,23,12,3,3,6
8467545,1,129,24,29,53
8467545,8,27,10,11,21
8467545,25,19,6,8,14
8460626,1,94,1,7,8
8476868,53,3,0,0,0
8471636,1,37,0,5,5
8473536,28,156,10,30,40
8473536,3,14,2,0,2
8475996,53,12,0,1,1
8475826,12,3,0,0,0
8470289,52,135,7,10,17
8476536,21,1,0,0,0
8473647,29,4,0,1,1
8466378,3,93,22,38,60
8466378,14,110,46,75,121
8475723,4,3,0,2,2
8471840,30,6,0,3,3
8471840,12,20,1,1,2
8476549,28,5,0,1,1
8459670,16,16,0,0,0
8459670,4,122,11,53,64
8474095,29,3,0,0,0
8474095,14,28,1,3,4
8476339,5,2,0,0,0
8470189,26,1,0,0,0
8470189,21,11,0,2,2
8469542,30,46,4,1,5
8475266,21,9,0,2,2
8475266,25,15,2,1,3
8468598,2,112,11,34,45
8468501,18,46,0,7,7
8468501,1,93,1,12,13
8475619,15,60,2,1,3
8475619,23,16,1,0,1
8474594,26,136,10,51,61
8468478,8,48,1,10,11
8468478,13,82,1,14,15
8469457,17,78,11,18,29
8469457,13,17,1,3,4
8476227,1,5,1,0,1
8473700,21,43,0,9,9
8477913,20,3,0,0,0
8477410,22,1,0,0,0
8474012,52,9,1,0,1
8469626,23,34,0,1,1
8460621,17,68,18,31,49
8460621,9,47,10,16,26
8475332,17,2,1,0,1
8475833,20,1,0,0,0
8465025,3,33,2,0,2
8469779,19,2,0,0,0
8469779,2,41,6,6,12
8467428,13,55,0,4,4
8467428,1,22,0,0,0
8477289,22,57,1,6,7
8459444,17,66,11,8,19
8476827,20,10,0,3,3
8470713,53,67,2,12,14
8470153,2,28,4,5,9
8470153,30,43,8,12,20
8465914,8,100,3,12,15
8475648,20,9,0,2,2
8476304,10,5,0,1,1
8469992,16,74,3,5,8
8471680,53,3,0,0,0
8475637,13,2,0,1,1
8475637,18,20,3,6,9
8475637,1,14,1,1,2
8477836,16,2,1,0,1
8467931,2,75,0,5,5
8466215,9,25,3,7,10
8466215,12,40,6,11,17
8468745,14,19,0,4,4
8470156,13,9,0,1,1
8470156,15,26,2,0,2
8474837,20,8,1,2,3
8471851,7,49,5,6,11
8471851,5,8,0,1,1
8471851,19,16,1,1,2
8471851,1,13,2,2,4
8476205,9,21,4,2,6
8474598,15,3,0,0,0
8475190,10,2,0,0,0
8471352,30,3,0,0,0
8471832,5,1,0,0,0
8471832,29,8,0,0,0
8462041,12,60,4,5,9
8462041,24,9,4,0,4
8470280,22,21,1,2,3
8473558,17,66,5,5,10
8467365,15,67,4,6,10
8473600,23,2,0,0,0
8473600,3,4,0,1,1
8475845,6,4,1,1,2
8469798,25,1,0,1,1
8474236,2,4,0,0,0
8459628,4,6,0,0,0
8459628,18,32,0,0,0
8475118,13,16,1,1,2
8475118,3,15,0,0,0
8470268,22,7,0,1,1
8475640,4,58,5,13,18
8467925,4,91,4,5,9
8467925,14,20,0,4,4
8467925,12,6,0,0,0
8476765,2,20,1,0,1
8467831,53,69,5,7,12
8467831,3,30,0,1,1
8467831,8,16,1,1,2
8462129,16,70,5,17,22
8462129,28,28,1,1,2
8475196,20,16,1,2,3
8475889,8,5,0,0,0
8475264,22,2,1,0,1
8475264,20,21,2,5,7
8470596,29,36,5,14,19
8470596,6,43,13,9,22
8470123,1,28,3,0,3
8476086,2,2,0,0,0
8471280,6,9,0,0,0
8471280,53,17,4,2,6
8471323,22,79,4,9,13
8460492,13,43,1,5,6
8471719,9,48,2,1,3
8471842,53,37,2,6,8
8471842,28,13,2,0,2
8468484,53,63,3,9,12
8469467,5,33,2,0,2
8469467,21,37,5,4,9
8459442,24,112,19,37,56
8469460,12,32,0,4,4
8469460,10,4,0,0,0
8469820,30,73,1,1,2
8469820,7,23,0,1,1
8477082,14,3,0,1,1
8477832,14,1,0,0,0
8474201,14,32,2,1,3
8477201,23,9,1,0,1
8475183,8,8,0,0,0
8473505,15,1,0,0,0
8474551,7,66,2,19,21
8471428,5,1,0,0,0
8474681,1,76,12,12,24
8474681,12,20,3,7,10
8475283,25,12,2,2,4
8475283,20,1,0,0,0
8475283,6,3,0,0,0
8468101,2,26,3,3,6
8473712,10,62,3,2,5
8473712,28,1,0,0,0
8474077,30,1,0,0,0
8476206,53,8,0,2,2
8473927,16,3,0,0,0
8464966,53,102,5,23,28
8477666,18,6,1,1,2
8466309,13,8,0,0,0
8468114,8,53,0,2,2
8468114,28,29,0,3,3
8468114,5,14,1,2,3
8475198,8,1,0,0,0
8470232,4,4,0,1,1
8470232,3,6,0,1,1
8471220,1,10,0,2,2
8474059,7,13,0,2,2
8474059,22,1,0,0,0
8474030,12,2,0,0,0
8474030,21,25,2,7,9
8468095,8,22,0,1,1
8468095,13,39,1,1,2
8476522,5,2,0,0,0
8471700,28,8,1,0,1
8469752,23,3,0,0,0
8471208,24,49,13,19,32
8471208,15,18,1,2,3
8471208,26,33,2,12,14
8476367,2,10,1,0,1
8471514,25,62,7,23,30
8471514,6,47,6,12,18
8473932,3,35,0,0,0
8473932,30,8,0,0,0
8467881,5,34,4,0,4
8467881,3,70,6,6,12
8476411,13,1,0,0,0
8470085,10,53,6,8,14
8470310,25,52,0,6,6
8470816,4,45,3,0,3
8467336,30,45,1,4,5
8467336,3,8,0,0,0
8465202,14,117,6,28,34
8467463,17,30,1,3,4
8464981,21,54,1,9,10
8464981,20,28,0,2,2
8474601,23,3,0,0,0
8457981,24,110,21,30,51
8473953,20,36,0,2,2
8468162,10,18,0,0,0
8468162,13,35,2,3,5
8468162,22,10,1,0,1
8460496,22,119,12,24,36
8470366,8,1,0,0,0
8469483,24,27,1,5,6
8469483,10,13,0,1,1
8471708,15,3,0,0,0
8470685,7,42,3,3,6
8476445,2,11,0,1,1
8466182,7,64,2,6,8
8466182,1,25,1,3,4
8474582,1,19,1,1,2
8468485,28,16,5,6,11
8468485,53,28,5,7,12
8475248,15,20,1,1,2
8475248,1,1,0,0,0
8477847,20,6,0,0,0
8474939,18,1,0,0,0
8475602,15,13,2,1,3
8473908,20,36,4,3,7
8473908,12,43,2,2,4
8475275,15,9,0,3,3
8458537,25,101,20,41,61
8470309,13,7,0,0,0
8470309,22,34,4,9,13
8474498,13,52,9,9,18
8474674,52,97,2,5,7
8471450,53,2,0,0,0
8471450,18,34,3,5,8
8467910,24,2,0,1,1
8467910,13,7,0,0,0
8474049,20,5,0,0,0
8473944,1,2,0,1,1
8467353,52,40,6,12,18
8469474,8,37,2,3,5
8459053,29,36,0,4,4
8470265,20,7,0,1,1
8474844,20,2,0,0,0
8476835,18,8,0,2,2
8471216,23,14,0,2,2
8464994,20,36,4,4,8
8465050,22,26,0,3,3
8469765,12,13,0,4,4
8469765,14,12,1,4,5
8471853,12,9,0,0,0
8471246,6,18,1,3,4
8470283,12,30,0,3,3
8471321,20,10,0,1,1
8473416,13,2,0,0,0
8476834,20,39,9,8,17
8465122,30,8,0,1,1
8473484,9,19,1,2,3
8473484,6,6,0,1,1
8474518,26,20,1,3,4
8474518,8,9,1,2,3
8467580,5,23,0,0,0
8470192,3,35,0,3,3
8468172,4,47,4,9,13
8471701,2,16,0,1,1
8468520,4,23,1,4,5
8471451,52,10,3,0,3
8470774,4,37,1,5,6
8474121,29,27,1,1,2
8471409,23,6,0,0,0
8458938,3,12,0,0,0
8458938,15,4,0,1,1
8474719,22,23,1,2,3
8462077,7,47,5,9,14
8460577,21,29,4,7,11
8471912,18,4,1,0,1
8472370,24,2,0,0,0
8468660,22,4,0,0,0
8467478,17,11,0,0,0
8467478,4,8,0,1,1
8469534,6,10,0,0,0
8471810,23,2,0,0,0
8465200,8,10,0,3,3
8458590,4,28,4,4,8
8475395,4,2,0,0,0
8471859,18,46,3,12,15
8466398,1,15,1,0,1
8458529,13,14,2,3,5
8462225,13,44,1,9,10
8474649,15,25,1,6,7
8474629,16,1,0,0,0
8459457,19,4,0,1,1
8469812,12,35,2,2,4
8471670,9,27,6,4,10
8477243,16,2,0,0,0
8471683,14,22,0,0,0
8468534,4,4,0,0,0
8468695,53,21,4,4,8
8468695,24,7,0,0,0
8471314,9,11,0,1,1
8465042,24,35,0,6,6
8470896,5,1,0,0,0
8459514,16,19,0,2,2
8468434,19,37,7,14,21
8470061,52,16,0,1,1
8468704,52,22,3,2,5
8471705,14,4,0,1,1
8473526,13,43,8,9,17
8469685,19,1,0,0,0
8473569,17,2,0,0,0
8459687,19,30,1,0,1
8473568,12,8,0,1,1
8470672,21,34,1,3,4
8470672,10,8,1,1,2
8474705,21,32,4,2,6
8459454,6,18,0,0,0
8473525,22,4,0,0,0
8476849,1,4,0,0,0
8467543,25,1,0,0,0
8474032,28,1,0,0,0
8471402,22,35,3,6,9
8470137,12,22,1,8,9
8467412,1,30,2,5,7
8467412,52,12,2,0,2
8465012,15,16,0,2,2
8459492,29,48,12,18,30
8473867,13,10,1,0,1
8475893,18,2,0,1,1
8464967,2,31,0,5,5
8462033,19,23,2,3,5
8462033,6,6,1,1,2
8473616,13,5,0,0,0
8470804,14,1,0,0,0
8473610,12,37,2,4,6
8469755,3,1,0,0,0
8462535,4,1,0,0,0
8460561,24,44,7,10,17
8474615,12,2,0,0,0
8471521,24,15,1,1,2
8460719,53,33,5,7,12
8460719,1,9,2,3,5
8474035,23,1,0,0,0
8470704,6,2,0,0,0
8475304,13,5,0,0,0
8474666,2,20,2,3,5
8473734,12,28,1,1,2
8471807,25,18,1,0,1
8470777,25,1,0,0,0
8474892,4,4,0,0,0
8469581,52,39,6,9,15
8470273,17,25,2,2,4
8471234,15,27,4,5,9
8471312,14,1,0,0,0
8468636,21,44,0,6,6
